league,season,team,player,nationality,position,age,birth_year,90s,tackles,tackles_won,tackles_def_third,tackles_mid_third,tackles_att_third,challenge_tackles,challenges_attempted,tackle_success_rate,challenges_lost,blocks,shots_blocked,passes_blocked,interceptions,tackles_plus_interceptions,clearances,errors
ENG-Premier League,2425,Arsenal,Bukayo Saka,,,22.0,2001.0,19.2,29,15,9,11,9,13,24,54.2,11,22,0,22,3,32,8,0
ENG-Premier League,2425,Arsenal,David Raya,,,28.0,1995.0,38.0,0,0,0,0,0,0,2,0.0,2,0,0,0,2,2,21,9
ENG-Premier League,2425,Arsenal,Declan Rice,,,25.0,1999.0,31.4,53,25,22,25,6,17,41,41.5,24,27,13,14,25,78,51,0
ENG-Premier League,2425,Arsenal,Ethan Nwaneri,,,17.0,2007.0,9.9,11,7,4,4,3,7,21,33.3,14,8,2,6,2,13,4,1
ENG-Premier League,2425,Arsenal,Gabriel Jesus,,,27.0,1997.0,6.8,10,6,4,3,3,4,9,44.4,5,10,1,9,4,14,8,0
ENG-Premier League,2425,Arsenal,Gabriel Magalhães,,,26.0,1997.0,26.3,25,15,12,8,5,12,16,75.0,4,42,29,13,16,41,93,2
ENG-Premier League,2425,Arsenal,Gabriel Martinelli,,,23.0,2001.0,25.4,23,15,9,6,8,7,23,30.4,16,15,0,15,5,28,19,0
ENG-Premier League,2425,Arsenal,Jakub Kiwior,,,24.0,2000.0,12.5,22,8,13,7,2,11,15,73.3,4,13,8,5,6,28,58,3
ENG-Premier League,2425,Arsenal,Jorginho,,,32.0,1991.0,7.8,12,4,1,7,4,8,20,40.0,12,3,0,3,7,19,2,2
ENG-Premier League,2425,Arsenal,Jurriën Timber,,,23.0,2001.0,26.9,58,38,17,30,11,18,27,66.7,9,19,4,15,22,80,44,1
ENG-Premier League,2425,Arsenal,Kai Havertz,,,25.0,1999.0,20.8,16,9,3,6,7,4,15,26.7,11,23,4,19,6,22,33,1
ENG-Premier League,2425,Arsenal,Kieran Tierney,,,27.0,1997.0,2.9,7,5,4,1,2,4,6,66.7,2,0,0,0,3,10,9,0
ENG-Premier League,2425,Arsenal,Leandro Trossard,,,29.0,1994.0,28.3,31,20,6,16,9,12,34,35.3,22,32,0,32,9,40,18,0
ENG-Premier League,2425,Arsenal,Martin Ødegaard,,,25.0,1998.0,25.8,19,11,9,7,3,4,25,16.0,21,5,0,5,6,25,6,1
ENG-Premier League,2425,Arsenal,Mikel Merino,,,28.0,1996.0,17.6,46,28,7,26,13,20,36,55.6,16,18,5,13,15,61,26,2
ENG-Premier League,2425,Arsenal,Myles Lewis-Skelly,,,17.0,2006.0,15.2,22,14,10,9,3,10,11,90.9,1,4,1,3,7,29,27,0
ENG-Premier League,2425,Arsenal,Nathan Butler-Oyedeji,,,21.0,2003.0,0.1,0,0,0,0,0,0,0,,0,0,0,0,0,0,0,0
ENG-Premier League,2425,Arsenal,Oleksandr Zinchenko,,,27.0,1996.0,5.9,6,1,1,3,2,3,8,37.5,5,8,1,7,5,11,10,0
ENG-Premier League,2425,Arsenal,Raheem Sterling,,,29.0,1994.0,5.5,9,4,1,3,5,5,10,50.0,5,3,0,3,1,10,4,0
ENG-Premier League,2425,Arsenal,Reiss Nelson,,,24.0,1999.0,0.0,1,0,0,1,0,0,1,0.0,1,0,0,0,0,1,1,0
ENG-Premier League,2425,Arsenal,Riccardo Calafiori,,,22.0,2002.0,10.9,27,19,15,10,2,18,29,62.1,11,12,6,6,9,36,25,0
ENG-Premier League,2425,Arsenal,Takehiro Tomiyasu,,,25.0,1998.0,0.1,0,0,0,0,0,0,0,,0,0,0,0,0,0,1,0
ENG-Premier League,2425,Arsenal,Thomas Partey,,,31.0,1993.0,31.1,89,53,26,39,24,46,76,60.5,30,29,9,20,35,124,49,4
ENG-Premier League,2425,Arsenal,William Saliba,,,23.0,2001.0,33.8,62,37,37,23,2,21,28,75.0,7,25,15,10,21,83,119,7
ENG-Premier League,2425,Aston Villa,Amadou Onana,,,22.0,2001.0,18.0,55,30,23,26,6,16,29,55.2,13,16,7,9,26,81,41,3
ENG-Premier League,2425,Aston Villa,Andrés García,,,21.0,2003.0,3.5,9,5,5,3,1,4,8,50.0,4,2,0,2,2,11,10,2
ENG-Premier League,2425,Aston Villa,Axel Disasi,,,26.0,1998.0,5.4,8,5,7,1,0,3,7,42.9,4,4,1,3,5,13,18,0
ENG-Premier League,2425,Aston Villa,Boubacar Kamara,,,24.0,1999.0,19.2,50,21,28,18,4,29,56,51.8,27,19,7,12,19,69,51,3
ENG-Premier League,2425,Aston Villa,Diego Carlos,,,31.0,1993.0,9.2,8,3,6,1,1,4,6,66.7,2,13,7,6,5,13,36,2
ENG-Premier League,2425,Aston Villa,Donyell Malen,,,25.0,1999.0,3.4,7,4,3,3,1,1,4,25.0,3,2,0,2,0,7,1,0
ENG-Premier League,2425,Aston Villa,Emi Buendía,,,27.0,1996.0,1.1,6,6,3,2,1,0,5,0.0,5,5,1,4,0,6,2,0
ENG-Premier League,2425,Aston Villa,Emiliano Martínez,,,31.0,1992.0,35.5,3,3,3,0,0,2,2,100.0,0,1,0,1,0,3,17,6
ENG-Premier League,2425,Aston Villa,Ezri Konsa,,,26.0,1997.0,32.6,34,18,20,10,4,20,25,80.0,5,20,11,9,24,58,114,4
ENG-Premier League,2425,Aston Villa,Ian Maatsen,,,22.0,2002.0,12.7,29,17,17,9,3,17,24,70.8,7,13,0,13,15,44,39,3
ENG-Premier League,2425,Aston Villa,Jacob Ramsey,,,23.0,2001.0,18.0,30,15,14,10,6,10,20,50.0,10,23,4,19,8,38,8,1
ENG-Premier League,2425,Aston Villa,Jaden Philogene Bidace,,,22.0,2002.0,3.7,11,5,4,7,0,4,6,66.7,2,5,0,5,3,14,2,1
ENG-Premier League,2425,Aston Villa,John McGinn,,,29.0,1994.0,24.7,33,24,10,14,9,13,31,41.9,18,22,2,20,14,47,18,3
ENG-Premier League,2425,Aston Villa,Jáder Durán,,,20.0,2003.0,7.1,8,7,1,2,5,1,4,25.0,3,5,0,5,0,8,13,0
ENG-Premier League,2425,Aston Villa,Kosta Nedeljković,,,18.0,2005.0,1.4,7,5,1,3,3,2,3,66.7,1,1,0,1,0,7,3,0
ENG-Premier League,2425,Aston Villa,Lamare Bogarde,,,20.0,2004.0,5.3,14,6,6,6,2,10,16,62.5,6,5,3,2,1,15,13,0
ENG-Premier League,2425,Aston Villa,Leon Bailey,,,26.0,1997.0,12.7,7,5,2,3,2,3,11,27.3,8,6,0,6,3,10,12,0
ENG-Premier League,2425,Aston Villa,Lucas Digne,,,31.0,1993.0,26.1,65,38,40,16,9,44,66,66.7,22,23,4,19,25,90,89,1
ENG-Premier League,2425,Aston Villa,Marco Asensio,,,28.0,1996.0,8.3,7,5,0,7,0,3,9,33.3,6,7,1,6,2,9,3,0
ENG-Premier League,2425,Aston Villa,Marcus Rashford,,,26.0,1997.0,4.9,10,7,2,3,5,4,6,66.7,2,2,0,2,1,11,3,0
ENG-Premier League,2425,Aston Villa,Matty Cash,,,26.0,1997.0,23.0,56,32,29,21,6,31,43,72.1,12,22,8,14,23,79,70,2
ENG-Premier League,2425,Aston Villa,Morgan Rogers,,,22.0,2002.0,34.6,43,22,15,15,13,24,47,51.1,23,26,7,19,6,49,20,2
ENG-Premier League,2425,Aston Villa,Ollie Watkins,,,28.0,1995.0,28.9,10,7,0,6,4,3,11,27.3,8,11,3,8,8,18,15,2
ENG-Premier League,2425,Aston Villa,Pau Torres,,,27.0,1997.0,22.4,21,15,11,8,2,10,17,58.8,7,16,11,5,10,31,75,2
ENG-Premier League,2425,Aston Villa,Robin Olsen,,,34.0,1990.0,2.5,1,0,1,0,0,1,1,100.0,0,0,0,0,0,1,2,1
ENG-Premier League,2425,Aston Villa,Ross Barkley,,,30.0,1993.0,6.5,14,3,4,10,0,9,14,64.3,5,9,3,6,10,24,5,0
ENG-Premier League,2425,Aston Villa,Tyrone Mings,,,31.0,1993.0,12.4,7,6,6,1,0,2,2,100.0,0,13,11,2,7,14,61,1
ENG-Premier League,2425,Aston Villa,Youri Tielemans,,,27.0,1997.0,33.6,84,58,32,44,8,40,73,54.8,33,38,16,22,23,107,47,4
ENG-Premier League,2425,Bournemouth,Adam Smith,,,33.0,1991.0,17.7,24,12,11,7,6,14,27,51.9,13,13,5,8,15,39,49,1
ENG-Premier League,2425,Bournemouth,Alex Scott,,,20.0,2003.0,8.4,27,14,11,8,8,19,42,45.2,23,17,4,13,10,37,15,0
ENG-Premier League,2425,Bournemouth,Antoine Semenyo,,,24.0,2000.0,35.6,55,35,17,25,13,16,43,37.2,27,67,9,58,11,66,39,2
ENG-Premier League,2425,Bournemouth,Ben Winterburn,,,19.0,2004.0,0.3,0,0,0,0,0,0,1,0.0,1,0,0,0,2,2,0,0
ENG-Premier League,2425,Bournemouth,Dango Ouattara,,,22.0,2002.0,22.3,35,26,14,11,10,17,41,41.5,24,36,10,26,11,46,51,0
ENG-Premier League,2425,Bournemouth,Daniel Jebbison,,,20.0,2003.0,1.3,5,3,3,2,0,4,6,66.7,2,2,1,1,1,6,1,0
ENG-Premier League,2425,Bournemouth,David Brooks,,,27.0,1997.0,10.7,14,6,2,8,4,2,16,12.5,14,18,2,16,5,19,9,1
ENG-Premier League,2425,Bournemouth,Dean Huijsen,,,19.0,2005.0,27.0,36,26,19,16,1,18,29,62.1,11,40,29,11,51,87,198,4
ENG-Premier League,2425,Bournemouth,Enes Ünal,,,27.0,1997.0,3.8,1,0,0,0,1,0,3,0.0,3,1,0,1,0,1,6,0
ENG-Premier League,2425,Bournemouth,Evanilson,,,24.0,1999.0,25.8,16,10,6,5,5,8,12,66.7,4,11,2,9,1,17,21,0
ENG-Premier League,2425,Bournemouth,Illia Zabarnyi,,,21.0,2002.0,34.5,52,36,31,20,1,34,50,68.0,16,33,20,13,41,93,182,2
ENG-Premier League,2425,Bournemouth,James Hill,,,22.0,2002.0,5.0,15,8,6,6,3,3,11,27.3,8,5,0,5,9,24,31,0
ENG-Premier League,2425,Bournemouth,Julian Araujo,,,22.0,2001.0,5.5,10,5,4,6,0,5,12,41.7,7,3,0,3,6,16,18,0
ENG-Premier League,2425,Bournemouth,Julio Soler,,,19.0,2005.0,0.1,1,1,1,0,0,1,1,100.0,0,1,0,1,0,1,0,0
ENG-Premier League,2425,Bournemouth,Justin Kluivert,,,25.0,1999.0,26.0,23,11,4,11,8,4,22,18.2,18,24,0,24,14,37,24,1
ENG-Premier League,2425,Bournemouth,Kepa Arrizabalaga,,,29.0,1994.0,31.0,1,0,1,0,0,0,2,0.0,2,2,0,2,0,1,15,3
ENG-Premier League,2425,Bournemouth,Lewis Cook,,,27.0,1997.0,33.1,81,42,41,36,4,37,67,55.2,30,30,11,19,41,122,70,0
ENG-Premier League,2425,Bournemouth,Luis Sinisterra,,,25.0,1999.0,2.6,7,2,3,2,2,0,4,0.0,4,3,0,3,1,8,8,0
ENG-Premier League,2425,Bournemouth,Marcos Senesi,,,27.0,1997.0,12.3,39,21,23,14,2,14,31,45.2,17,16,7,9,14,53,58,0
ENG-Premier League,2425,Bournemouth,Marcus Tavernier,,,25.0,1999.0,21.5,43,24,15,19,9,10,27,37.0,17,16,3,13,5,48,11,0
ENG-Premier League,2425,Bournemouth,Mark Travers,,,25.0,1999.0,5.0,0,0,0,0,0,0,0,,0,0,0,0,0,0,5,0
ENG-Premier League,2425,Bournemouth,Max Aarons,,,24.0,2000.0,1.0,2,2,1,1,0,1,1,100.0,0,3,1,2,1,3,0,0
ENG-Premier League,2425,Bournemouth,Milos Kerkez,,,20.0,2003.0,37.1,52,26,25,20,7,24,38,63.2,14,38,11,27,45,97,106,4
ENG-Premier League,2425,Bournemouth,Neto,,,35.0,1989.0,2.0,0,0,0,0,0,0,0,,0,0,0,0,0,0,1,1
ENG-Premier League,2425,Bournemouth,Philip Billing,,,28.0,1996.0,2.0,14,5,7,6,1,3,4,75.0,1,3,0,3,5,19,2,0
ENG-Premier League,2425,Bournemouth,Remy Rees-Dottin,,,18.0,2006.0,0.0,0,0,0,0,0,0,0,,0,0,0,0,0,0,0,0
ENG-Premier League,2425,Bournemouth,Ryan Christie,,,29.0,1995.0,23.5,54,33,19,27,8,27,64,42.2,37,44,11,33,30,84,51,3
ENG-Premier League,2425,Bournemouth,Tyler Adams,,,25.0,1999.0,21.8,83,50,26,49,8,39,72,54.2,33,33,10,23,32,115,42,0
ENG-Premier League,2425,Bournemouth,Zain Silcott-Duberry,,,19.0,2005.0,0.0,1,1,0,0,1,1,1,100.0,0,0,0,0,0,1,0,0
ENG-Premier League,2425,Brentford,Ben Mee,,,34.0,1989.0,2.0,2,2,0,2,0,1,1,100.0,0,3,3,0,4,6,7,0
ENG-Premier League,2425,Brentford,Bryan Mbeumo,,,24.0,1999.0,37.9,49,31,18,15,16,21,35,60.0,14,26,3,23,14,63,55,1
ENG-Premier League,2425,Brentford,Christian Nørgaard,,,30.0,1994.0,31.3,79,49,37,35,7,48,81,59.3,33,52,20,32,49,128,70,1
ENG-Premier League,2425,Brentford,Edmond-Paris Maghoma,,,23.0,2001.0,1.3,2,1,0,2,0,1,3,33.3,2,2,2,0,1,3,2,0
ENG-Premier League,2425,Brentford,Ethan Pinnock,,,31.0,1993.0,21.3,35,19,15,16,4,13,24,54.2,11,29,18,11,24,59,142,4
ENG-Premier League,2425,Brentford,Fabio Carvalho,,,21.0,2002.0,5.1,13,9,4,4,5,6,13,46.2,7,6,1,5,3,16,2,0
ENG-Premier League,2425,Brentford,Frank Onyeka,,,26.0,1998.0,0.3,0,0,0,0,0,0,0,,0,0,0,0,0,0,0,0
ENG-Premier League,2425,Brentford,Gustavo Nunes,,,18.0,2005.0,0.1,3,2,2,0,1,2,2,100.0,0,0,0,0,0,3,2,0
ENG-Premier League,2425,Brentford,Hákon Rafn Valdimarsson,,,22.0,2001.0,1.6,0,0,0,0,0,0,0,,0,0,0,0,0,0,2,0
ENG-Premier League,2425,Brentford,Jayden Meghoma,,,18.0,2006.0,0.1,0,0,0,0,0,0,0,,0,0,0,0,0,0,0,0
ENG-Premier League,2425,Brentford,Keane Lewis-Potter,,,23.0,2001.0,34.4,49,27,26,16,7,31,50,62.0,19,28,10,18,21,70,76,3
ENG-Premier League,2425,Brentford,Kevin Schade,,,22.0,2001.0,25.5,39,25,17,10,12,13,23,56.5,10,19,4,15,5,44,34,0
ENG-Premier League,2425,Brentford,Kim Jisoo,,,19.0,2004.0,0.3,0,0,0,0,0,0,0,,0,0,0,0,0,0,2,0
ENG-Premier League,2425,Brentford,Kristoffer Ajer,,,26.0,1998.0,16.0,26,18,14,11,1,14,27,51.9,13,17,4,13,12,38,50,0
ENG-Premier League,2425,Brentford,Mads Roerslev,,,25.0,1999.0,12.2,18,8,14,3,1,11,28,39.3,17,12,5,7,4,22,35,0
ENG-Premier League,2425,Brentford,Mark Flekken,,,31.0,1993.0,36.4,4,4,4,0,0,3,9,33.3,6,2,0,2,0,4,26,4
ENG-Premier League,2425,Brentford,Mathias Jensen,,,28.0,1996.0,9.6,14,10,6,6,2,8,16,50.0,8,15,4,11,8,22,13,2
ENG-Premier League,2425,Brentford,Michael Kayode,,,20.0,2004.0,5.9,17,11,12,5,0,9,13,69.2,4,3,0,3,7,24,19,0
ENG-Premier League,2425,Brentford,Mikkel Damsgaard,,,24.0,2000.0,32.3,83,44,27,29,27,31,81,38.3,50,40,3,37,27,110,31,2
ENG-Premier League,2425,Brentford,Nathan Collins,,,23.0,2001.0,38.0,40,24,23,12,5,22,36,61.1,14,77,57,20,34,74,226,3
ENG-Premier League,2425,Brentford,Rico Henry,,,27.0,1997.0,1.1,2,2,1,0,1,0,4,0.0,4,4,1,3,1,3,2,0
ENG-Premier League,2425,Brentford,Ryan Trevitt,,,21.0,2003.0,0.0,1,1,1,0,0,0,0,,0,0,0,0,0,1,0,0
ENG-Premier League,2425,Brentford,Sepp van den Berg,,,22.0,2001.0,28.7,39,24,25,10,4,19,29,65.5,10,52,38,14,21,60,134,3
ENG-Premier League,2425,Brentford,Thiago,,,23.0,2001.0,1.9,5,3,2,1,2,0,1,0.0,1,3,0,3,2,7,3,1
ENG-Premier League,2425,Brentford,Vitaly Janelt,,,26.0,1998.0,25.0,38,22,14,13,11,21,36,58.3,15,33,9,24,27,65,53,1
ENG-Premier League,2425,Brentford,Yehor Yarmoliuk,,,20.0,2004.0,16.1,49,28,21,21,7,28,55,50.9,27,26,9,17,13,62,33,0
ENG-Premier League,2425,Brentford,Yoane Wissa,,,27.0,1996.0,32.4,22,12,6,8,8,11,27,40.7,16,29,8,21,8,30,21,3
ENG-Premier League,2425,Brentford,Yunus Emre Konak,,,18.0,2006.0,0.5,4,4,0,4,0,1,2,50.0,1,2,0,2,0,4,0,0
ENG-Premier League,2425,Brighton,Adam Webster,,,29.0,1995.0,9.9,10,6,5,4,1,6,14,42.9,8,16,9,7,20,30,41,2
ENG-Premier League,2425,Brighton,Bart Verbruggen,,,21.0,2002.0,36.0,0,0,0,0,0,0,3,0.0,3,1,0,1,0,0,29,5
ENG-Premier League,2425,Brighton,Billy Gilmour,,,23.0,2001.0,1.1,3,3,2,1,0,3,4,75.0,1,1,0,1,0,3,1,0
ENG-Premier League,2425,Brighton,Brajan Gruda,,,20.0,2004.0,7.6,16,8,6,6,4,7,14,50.0,7,8,0,8,2,18,5,1
ENG-Premier League,2425,Brighton,Carlos Baleba,,,20.0,2004.0,29.6,79,46,26,37,16,48,80,60.0,32,47,11,36,46,125,44,1
ENG-Premier League,2425,Brighton,Danny Welbeck,,,33.0,1990.0,23.5,26,16,6,15,5,8,20,40.0,12,19,4,15,5,31,14,0
ENG-Premier League,2425,Brighton,Diego Gómez,,,21.0,2003.0,5.7,21,13,11,8,2,12,22,54.5,10,13,0,13,8,29,10,1
ENG-Premier League,2425,Brighton,Eiran Cashin,,,22.0,2001.0,0.2,0,0,0,0,0,0,1,0.0,1,0,0,0,0,0,2,0
ENG-Premier League,2425,Brighton,Evan Ferguson,,,19.0,2004.0,2.7,4,3,0,3,1,2,5,40.0,3,3,1,2,0,4,4,0
ENG-Premier League,2425,Brighton,Ferdi Kadioglu,,,24.0,1999.0,4.3,10,6,4,5,1,6,15,40.0,9,2,2,0,8,18,17,0
ENG-Premier League,2425,Brighton,Georginio Rutter,,,22.0,2002.0,18.4,39,15,13,18,8,14,36,38.9,22,20,3,17,10,49,13,2
ENG-Premier League,2425,Brighton,Harry Howell,,,15.0,2008.0,0.1,1,1,1,0,0,1,2,50.0,1,1,0,1,0,1,0,0
ENG-Premier League,2425,Brighton,Igor,,,26.0,1998.0,10.7,5,5,2,2,1,4,10,40.0,6,24,14,10,4,9,39,1
ENG-Premier League,2425,Brighton,Jack Hinshelwood,,,19.0,2005.0,20.5,27,19,8,10,9,11,27,40.7,16,10,3,7,16,43,37,1
ENG-Premier League,2425,Brighton,Jakub Moder,,,25.0,1999.0,0.1,1,0,1,0,0,0,2,0.0,2,0,0,0,0,1,3,0
ENG-Premier League,2425,Brighton,James Milner,,,38.0,1986.0,1.9,5,2,1,3,1,3,3,100.0,0,4,2,2,2,7,2,1
ENG-Premier League,2425,Brighton,Jan Paul van Hecke,,,24.0,2000.0,32.9,45,29,24,19,2,23,41,56.1,18,37,22,15,24,69,142,2
ENG-Premier League,2425,Brighton,Jason Steele,,,33.0,1990.0,2.0,0,0,0,0,0,0,0,,0,0,0,0,0,0,1,0
ENG-Premier League,2425,Brighton,Jeremy Sarmiento,,,22.0,2002.0,0.1,0,0,0,0,0,0,0,,0,0,0,0,0,0,0,0
ENG-Premier League,2425,Brighton,João Pedro,,,22.0,2001.0,21.6,16,12,6,6,4,4,11,36.4,7,12,0,12,9,25,12,0
ENG-Premier League,2425,Brighton,Joël Veltman,,,32.0,1992.0,18.9,43,29,24,16,3,31,52,59.6,21,22,7,15,19,62,66,0
ENG-Premier League,2425,Brighton,Julio Enciso,,,20.0,2004.0,3.3,0,0,0,0,0,0,2,0.0,2,2,0,2,0,0,1,0
ENG-Premier League,2425,Brighton,Kaoru Mitoma,,,27.0,1997.0,28.9,45,27,15,14,16,19,49,38.8,30,48,3,45,14,59,10,0
ENG-Premier League,2425,Brighton,Lewis Dunk,,,32.0,1991.0,23.1,17,10,8,7,2,11,19,57.9,8,28,18,10,13,30,79,2
ENG-Premier League,2425,Brighton,Mats Wieffer,,,24.0,1999.0,11.3,58,34,27,27,4,32,47,68.1,15,18,2,16,17,75,28,3
ENG-Premier League,2425,Brighton,Matt O'Riley,,,23.0,2000.0,10.4,16,9,4,8,4,4,13,30.8,9,7,3,4,13,29,9,1
ENG-Premier League,2425,Brighton,Pervis Estupiñán,,,26.0,1998.0,26.7,65,43,33,25,7,34,51,66.7,17,20,5,15,37,102,65,2
ENG-Premier League,2425,Brighton,Simon Adingra,,,22.0,2002.0,12.2,23,14,10,8,5,10,26,38.5,16,12,0,12,8,31,6,2
ENG-Premier League,2425,Brighton,Solly March,,,30.0,1994.0,1.9,6,3,2,2,2,5,8,62.5,3,3,0,3,2,8,2,1
ENG-Premier League,2425,Brighton,Tariq Lamptey,,,23.0,2000.0,9.6,17,11,8,9,0,9,25,36.0,16,15,7,8,7,24,23,1
ENG-Premier League,2425,Brighton,Yankuba Minteh,,,20.0,2004.0,20.4,48,35,25,13,10,17,45,37.8,28,22,0,22,11,59,31,0
ENG-Premier League,2425,Brighton,Yasin Ayari,,,20.0,2003.0,21.8,59,32,15,31,13,26,56,46.4,30,24,6,18,20,79,26,0
ENG-Premier League,2425,Chelsea,Axel Disasi,,,26.0,1998.0,4.0,7,4,5,1,1,6,11,54.5,5,4,1,3,2,9,11,1
ENG-Premier League,2425,Chelsea,Benoît Badiashile,,,23.0,2001.0,3.7,9,6,5,4,0,4,5,80.0,1,2,2,0,6,15,12,2
ENG-Premier League,2425,Chelsea,Christopher Nkunku,,,26.0,1997.0,10.2,12,8,3,4,5,6,8,75.0,2,9,2,7,7,19,10,0
ENG-Premier League,2425,Chelsea,Cole Palmer,,,22.0,2002.0,35.5,34,20,12,10,12,12,27,44.4,15,16,1,15,11,45,20,1
ENG-Premier League,2425,Chelsea,Enzo Fernández,,,23.0,2001.0,32.7,65,33,17,30,18,31,84,36.9,53,43,7,36,13,78,23,4
ENG-Premier League,2425,Chelsea,Filip Jørgensen,,,22.0,2002.0,6.0,0,0,0,0,0,0,0,,0,0,0,0,0,0,0,3
ENG-Premier League,2425,Chelsea,Jadon Sancho,,,24.0,2000.0,19.6,13,7,3,3,7,5,12,41.7,7,11,0,11,2,15,8,2
ENG-Premier League,2425,Chelsea,Joshua Acheampong,,,18.0,2006.0,1.9,2,1,2,0,0,2,2,100.0,0,1,0,1,1,3,2,0
ENG-Premier League,2425,Chelsea,João Félix,,,24.0,1999.0,4.1,8,3,2,5,1,5,9,55.6,4,2,0,2,3,11,2,0
ENG-Premier League,2425,Chelsea,Kiernan Dewsbury-Hall,,,25.0,1998.0,2.9,8,5,1,1,6,4,6,66.7,2,2,0,2,2,10,9,1
ENG-Premier League,2425,Chelsea,Levi Colwill,,,21.0,2003.0,35.0,47,34,25,19,3,18,27,66.7,9,37,25,12,33,80,118,4
ENG-Premier League,2425,Chelsea,Malo Gusto,,,21.0,2003.0,20.7,45,29,27,15,3,25,48,52.1,23,29,8,21,24,69,49,5
ENG-Premier League,2425,Chelsea,Marc Cucurella,,,26.0,1998.0,33.2,67,45,31,31,5,32,61,52.5,29,49,16,33,28,95,95,3
ENG-Premier League,2425,Chelsea,Marc Guiu,,,18.0,2006.0,0.8,1,1,0,1,0,1,1,100.0,0,0,0,0,0,1,0,0
ENG-Premier League,2425,Chelsea,Mathis Amougou,,,18.0,2006.0,0.1,0,0,0,0,0,0,0,,0,0,0,0,0,0,0,0
ENG-Premier League,2425,Chelsea,Moisés Caicedo,,,22.0,2001.0,37.2,114,73,44,54,16,54,86,62.8,32,49,10,39,49,163,60,1
ENG-Premier League,2425,Chelsea,Mykhailo Mudryk,,,23.0,2001.0,1.7,2,2,2,0,0,0,0,,0,3,1,2,0,2,1,0
ENG-Premier League,2425,Chelsea,Nicolas Jackson,,,23.0,2001.0,24.7,22,13,6,7,9,5,10,50.0,5,15,2,13,3,25,15,0
ENG-Premier League,2425,Chelsea,Noni Madueke,,,22.0,2002.0,22.6,25,18,8,12,5,14,38,36.8,24,17,0,17,10,35,11,0
ENG-Premier League,2425,Chelsea,Pedro Neto,,,24.0,2000.0,25.2,23,9,9,9,5,9,21,42.9,12,14,2,12,9,32,6,0
ENG-Premier League,2425,Chelsea,Reece James,,,24.0,1999.0,11.8,10,9,6,3,1,3,9,33.3,6,14,6,8,13,23,23,4
ENG-Premier League,2425,Chelsea,Renato Veiga,,,21.0,2003.0,2.0,9,6,6,3,0,4,12,33.3,8,3,1,2,1,10,2,0
ENG-Premier League,2425,Chelsea,Robert Sánchez,,,26.0,1997.0,32.0,0,0,0,0,0,0,1,0.0,1,0,0,0,2,2,24,10
ENG-Premier League,2425,Chelsea,Roméo Lavia,,,20.0,2004.0,8.9,22,13,5,13,4,10,21,47.6,11,6,0,6,16,38,10,1
ENG-Premier League,2425,Chelsea,Shumaira Mheuka,,,16.0,2007.0,0.0,0,0,0,0,0,0,0,,0,0,0,0,0,0,0,0
ENG-Premier League,2425,Chelsea,Tosin Adarabioyo,,,26.0,1997.0,15.7,17,13,11,6,0,8,12,66.7,4,9,7,2,11,28,80,0
ENG-Premier League,2425,Chelsea,Trevoh Chalobah,,,25.0,1999.0,10.1,11,7,5,6,0,7,8,87.5,1,6,3,3,10,21,48,1
ENG-Premier League,2425,Chelsea,Tyrique George,,,18.0,2006.0,2.0,2,0,2,0,0,2,3,66.7,1,1,0,1,2,4,1,0
ENG-Premier League,2425,Chelsea,Wesley Fofana,,,23.0,2000.0,13.0,13,12,6,7,0,6,14,42.9,8,14,9,5,14,27,55,2
ENG-Premier League,2425,Crystal Palace,Adam Wharton,,,20.0,2004.0,14.6,34,14,14,16,4,17,44,38.6,27,11,2,9,20,54,27,0
ENG-Premier League,2425,Crystal Palace,Asher Agbinone,,,18.0,2005.0,0.1,2,1,0,2,0,0,0,,0,0,0,0,0,2,0,0
ENG-Premier League,2425,Crystal Palace,Ben Chilwell,,,27.0,1996.0,2.9,7,6,4,3,0,1,5,20.0,4,6,2,4,6,13,16,0
ENG-Premier League,2425,Crystal Palace,Caleb Kporha,,,18.0,2006.0,0.1,2,1,2,0,0,2,2,100.0,0,0,0,0,0,2,1,0
ENG-Premier League,2425,Crystal Palace,Chadi Riad,,,21.0,2003.0,1.0,5,2,2,2,1,2,3,66.7,1,0,0,0,2,7,0,0
ENG-Premier League,2425,Crystal Palace,Cheick Doucouré,,,24.0,2000.0,5.0,16,8,6,8,2,5,11,45.5,6,4,0,4,11,27,10,1
ENG-Premier League,2425,Crystal Palace,Chris Richards,,,24.0,2000.0,21.4,47,30,24,17,6,24,41,58.5,17,40,14,26,19,66,121,0
ENG-Premier League,2425,Crystal Palace,Daichi Kamada,,,27.0,1996.0,17.4,47,29,19,24,4,14,41,34.1,27,22,5,17,18,65,14,0
ENG-Premier League,2425,Crystal Palace,Daniel Muñoz,,,28.0,1996.0,35.9,123,80,57,41,25,55,97,56.7,42,40,6,34,44,167,108,1
ENG-Premier League,2425,Crystal Palace,Dean Henderson,,,27.0,1997.0,38.0,2,1,2,0,0,2,6,33.3,4,0,0,0,0,2,22,0
ENG-Premier League,2425,Crystal Palace,Eberechi Eze,,,26.0,1998.0,28.8,39,22,14,16,9,17,36,47.2,19,27,0,27,11,50,10,3
ENG-Premier League,2425,Crystal Palace,Eddie Nketiah,,,25.0,1999.0,11.5,15,8,7,4,4,7,13,53.8,6,10,1,9,3,18,12,0
ENG-Premier League,2425,Crystal Palace,Ismaila Sarr,,,26.0,1998.0,30.1,22,10,10,9,3,8,25,32.0,17,27,8,19,9,31,40,0
ENG-Premier League,2425,Crystal Palace,Jean-Philippe Mateta,,,27.0,1997.0,29.4,18,12,5,11,2,3,16,18.8,13,19,4,15,2,20,23,0
ENG-Premier League,2425,Crystal Palace,Jefferson Lerma,,,29.0,1994.0,25.3,35,17,15,16,4,19,36,52.8,17,38,18,20,42,77,80,1
ENG-Premier League,2425,Crystal Palace,Jeffrey Schlupp,,,31.0,1992.0,1.1,2,0,1,0,1,0,3,0.0,3,6,0,6,0,2,2,0
ENG-Premier League,2425,Crystal Palace,Joachim Andersen,,,28.0,1996.0,1.0,1,1,1,0,0,1,2,50.0,1,0,0,0,0,1,7,0
ENG-Premier League,2425,Crystal Palace,Joel Ward,,,34.0,1989.0,0.8,2,0,0,2,0,0,0,,0,0,0,0,0,2,3,0
ENG-Premier League,2425,Crystal Palace,Jordan Ayew,,,32.0,1991.0,0.2,1,0,0,0,1,0,0,,0,0,0,0,0,1,0,0
ENG-Premier League,2425,Crystal Palace,Justin Devenny,,,20.0,2003.0,5.6,17,12,7,9,1,8,19,42.1,11,6,1,5,0,17,11,0
ENG-Premier League,2425,Crystal Palace,Marc Guéhi,,,24.0,2000.0,34.0,61,34,36,23,2,31,47,66.0,16,55,23,32,28,89,163,2
ENG-Premier League,2425,Crystal Palace,Matheus França,,,20.0,2004.0,0.6,2,0,0,2,0,0,0,,0,1,1,0,1,3,1,0
ENG-Premier League,2425,Crystal Palace,Maxence Lacroix,,,24.0,2000.0,34.6,68,41,52,15,1,32,47,68.1,15,48,22,26,54,122,207,2
ENG-Premier League,2425,Crystal Palace,Nathaniel Clyne,,,33.0,1991.0,5.4,12,8,8,3,1,6,11,54.5,5,4,2,2,3,15,14,1
ENG-Premier League,2425,Crystal Palace,Odsonne Édouard,,,26.0,1998.0,1.3,1,0,0,1,0,0,2,0.0,2,1,0,1,0,1,1,0
ENG-Premier League,2425,Crystal Palace,Romain Esse,,,19.0,2005.0,1.5,9,6,4,3,2,5,5,100.0,0,2,0,2,1,10,2,0
ENG-Premier League,2425,Crystal Palace,Trevoh Chalobah,,,25.0,1999.0,11.8,20,16,7,12,1,12,23,52.2,11,19,9,10,19,39,57,3
ENG-Premier League,2425,Crystal Palace,Tyrick Mitchell,,,24.0,1999.0,34.4,91,55,57,27,7,25,46,54.3,21,68,12,56,19,110,108,2
ENG-Premier League,2425,Crystal Palace,Will Hughes,,,29.0,1995.0,23.4,66,36,20,33,13,28,62,45.2,34,31,14,17,22,88,28,3
ENG-Premier League,2425,Everton,Abdoulaye Doucouré,,,31.0,1993.0,28.5,48,28,21,20,7,14,43,32.6,29,31,6,25,10,58,20,1
ENG-Premier League,2425,Everton,Armando Broja,,,22.0,2001.0,3.7,3,1,1,1,1,0,0,,0,3,0,3,1,4,4,0
ENG-Premier League,2425,Everton,Ashley Young,,,39.0,1985.0,20.8,58,33,25,25,8,35,57,61.4,22,14,4,10,25,83,64,2
ENG-Premier League,2425,Everton,Beto,,,26.0,1998.0,17.0,14,6,2,8,4,5,8,62.5,3,12,2,10,4,18,24,1
ENG-Premier League,2425,Everton,Carlos Alcaraz,,,21.0,2002.0,8.5,11,5,5,3,3,3,11,27.3,8,9,2,7,5,16,10,0
ENG-Premier League,2425,Everton,Dominic Calvert-Lewin,,,27.0,1997.0,17.9,9,7,1,4,4,2,6,33.3,4,7,2,5,7,16,23,0
ENG-Premier League,2425,Everton,Dwight McNeil,,,24.0,1999.0,15.2,13,8,6,5,2,9,21,42.9,12,7,0,7,6,19,2,1
ENG-Premier League,2425,Everton,Harrison Armstrong,,,17.0,2007.0,0.5,0,0,0,0,0,0,1,0.0,1,0,0,0,0,0,1,0
ENG-Premier League,2425,Everton,Idrissa Gana Gueye,,,34.0,1989.0,34.0,133,80,61,55,17,58,99,58.6,41,48,9,39,48,181,36,1
ENG-Premier League,2425,Everton,Iliman Ndiaye,,,24.0,2000.0,27.0,53,28,20,16,17,22,49,44.9,27,30,5,25,20,73,24,1
ENG-Premier League,2425,Everton,Jack Harrison,,,27.0,1996.0,23.1,32,22,12,12,8,15,46,32.6,31,18,2,16,10,42,35,2
ENG-Premier League,2425,Everton,Jake O'Brien,,,23.0,2001.0,17.5,26,17,21,5,0,17,25,68.0,8,17,4,13,4,30,93,0
ENG-Premier League,2425,Everton,James Garner,,,23.0,2001.0,17.7,47,31,25,20,2,24,41,58.5,17,20,4,16,23,70,37,0
ENG-Premier League,2425,Everton,James Tarkowski,,,31.0,1992.0,32.5,64,40,39,22,3,24,39,61.5,15,57,42,15,41,105,213,4
ENG-Premier League,2425,Everton,Jarrad Branthwaite,,,22.0,2002.0,27.9,36,20,26,10,0,20,28,71.4,8,31,23,8,27,63,191,4
ENG-Premier League,2425,Everton,Jesper Lindstrøm,,,24.0,2000.0,13.8,45,25,24,19,2,19,55,34.5,36,15,3,12,12,57,17,0
ENG-Premier League,2425,Everton,Jordan Pickford,,,30.0,1994.0,38.0,1,0,1,0,0,1,2,50.0,1,0,0,0,1,2,30,2
ENG-Premier League,2425,Everton,Mason Holgate,,,27.0,1996.0,0.1,0,0,0,0,0,0,0,,0,0,0,0,0,0,0,0
ENG-Premier League,2425,Everton,Michael Keane,,,31.0,1993.0,11.7,12,9,8,2,2,8,15,53.3,7,14,10,4,16,28,65,2
ENG-Premier League,2425,Everton,Nathan Patterson,,,22.0,2001.0,3.9,11,6,7,4,0,7,14,50.0,7,2,0,2,2,13,7,0
ENG-Premier League,2425,Everton,Orel Mangala,,,26.0,1998.0,14.0,16,8,3,11,2,5,8,62.5,3,8,3,5,21,37,24,1
ENG-Premier League,2425,Everton,Roman Dixon,,,19.0,2004.0,1.0,5,5,3,2,0,4,4,100.0,0,1,0,1,1,6,3,0
ENG-Premier League,2425,Everton,Séamus Coleman,,,35.0,1988.0,2.4,3,2,2,1,0,3,4,75.0,1,5,3,2,1,4,8,0
ENG-Premier League,2425,Everton,Tim Iroegbunam,,,21.0,2003.0,6.4,29,14,14,10,5,14,23,60.9,9,18,4,14,16,45,12,1
ENG-Premier League,2425,Everton,Vitaliy Mykolenko,,,25.0,1999.0,34.2,63,38,39,14,10,29,56,51.8,27,25,10,15,44,107,145,2
ENG-Premier League,2425,Everton,Youssef Chermiti,,,20.0,2004.0,0.5,0,0,0,0,0,0,1,0.0,1,0,0,0,0,0,0,0
ENG-Premier League,2425,Fulham,Adama Traoré,,,28.0,1996.0,19.7,20,13,9,6,5,5,13,38.5,8,7,0,7,1,21,6,4
ENG-Premier League,2425,Fulham,Alex Iwobi,,,28.0,1996.0,33.1,44,25,14,21,9,22,34,64.7,12,26,1,25,14,58,29,1
ENG-Premier League,2425,Fulham,Andreas Pereira,,,28.0,1996.0,22.4,24,13,8,11,5,10,42,23.8,32,17,2,15,8,32,17,3
ENG-Premier League,2425,Fulham,Antonee Robinson,,,26.0,1997.0,35.2,95,61,57,31,7,45,95,47.4,50,43,9,34,62,157,133,2
ENG-Premier League,2425,Fulham,Bernd Leno,,,32.0,1992.0,38.0,2,2,2,0,0,2,2,100.0,0,1,0,1,0,2,11,5
ENG-Premier League,2425,Fulham,Calvin Bassey,,,24.0,1999.0,34.2,54,34,35,19,0,22,31,71.0,9,40,17,23,20,74,118,8
ENG-Premier League,2425,Fulham,Carlos Vinícius,,,29.0,1995.0,0.2,0,0,0,0,0,0,1,0.0,1,1,0,1,0,0,0,0
ENG-Premier League,2425,Fulham,Emile Smith Rowe,,,24.0,2000.0,22.7,31,18,7,14,10,8,24,33.3,16,22,2,20,11,42,16,0
ENG-Premier League,2425,Fulham,Harrison Reed,,,29.0,1995.0,1.2,6,3,3,2,1,1,3,33.3,2,1,0,1,1,7,3,0
ENG-Premier League,2425,Fulham,Harry Wilson,,,27.0,1997.0,12.9,20,14,13,3,4,12,18,66.7,6,15,1,14,7,27,10,1
ENG-Premier League,2425,Fulham,Issa Diop,,,27.0,1997.0,14.9,26,12,18,8,0,13,18,72.2,5,10,7,3,9,35,72,2
ENG-Premier League,2425,Fulham,Jay Stansfield,,,21.0,2002.0,0.0,0,0,0,0,0,0,0,,0,0,0,0,0,0,0,0
ENG-Premier League,2425,Fulham,Joachim Andersen,,,28.0,1996.0,28.7,27,18,20,6,1,15,24,62.5,9,37,28,9,34,61,188,1
ENG-Premier League,2425,Fulham,Jorge Cuenca,,,24.0,1999.0,3.9,6,2,5,1,0,3,8,37.5,5,4,4,0,2,8,26,0
ENG-Premier League,2425,Fulham,Joshua King,,,17.0,2007.0,1.4,7,5,3,4,0,0,3,0.0,3,3,0,3,1,8,1,0
ENG-Premier League,2425,Fulham,Kenny Tete,,,28.0,1995.0,19.7,56,38,29,14,13,23,38,60.5,15,31,12,19,32,88,67,0
ENG-Premier League,2425,Fulham,Martial Godo,,,21.0,2003.0,0.3,0,0,0,0,0,0,0,,0,1,0,1,1,1,0,0
ENG-Premier League,2425,Fulham,Raúl Jiménez,,,33.0,1991.0,27.7,35,24,9,17,9,8,22,36.4,14,21,5,16,10,45,23,3
ENG-Premier League,2425,Fulham,Reiss Nelson,,,24.0,1999.0,5.4,8,6,3,3,2,5,13,38.5,8,11,0,11,5,13,2,0
ENG-Premier League,2425,Fulham,Rodrigo Muniz,,,23.0,2001.0,10.7,10,5,3,5,2,4,4,100.0,0,9,2,7,5,15,14,0
ENG-Premier League,2425,Fulham,Ryan Sessegnon,,,24.0,2000.0,6.4,27,13,11,11,5,9,20,45.0,11,13,1,12,3,30,18,0
ENG-Premier League,2425,Fulham,Sander Berge,,,26.0,1998.0,24.7,50,30,23,23,4,27,39,69.2,12,27,8,19,21,71,38,1
ENG-Premier League,2425,Fulham,Saša Lukić,,,27.0,1996.0,26.0,68,39,22,40,6,23,55,41.8,32,20,7,13,28,96,35,1
ENG-Premier League,2425,Fulham,Timothy Castagne,,,28.0,1995.0,18.3,46,29,28,15,3,26,45,57.8,19,15,6,9,22,68,83,0
ENG-Premier League,2425,Fulham,Tom Cairney,,,33.0,1991.0,7.0,13,5,5,2,6,4,7,57.1,3,7,1,6,4,17,3,1
ENG-Premier League,2425,Fulham,Willian,,,35.0,1988.0,2.9,4,2,0,3,1,2,6,33.3,4,0,0,0,1,5,1,0
ENG-Premier League,2425,Ipswich Town,Alex Palmer,,,27.0,1996.0,13.0,0,0,0,0,0,0,0,,0,0,0,0,0,0,12,0
ENG-Premier League,2425,Ipswich Town,Ali Al Hamadi,,,22.0,2002.0,1.5,1,0,0,0,1,0,2,0.0,2,0,0,0,0,1,2,0
ENG-Premier League,2425,Ipswich Town,Arijanet Muric,,,25.0,1998.0,18.0,0,0,0,0,0,0,2,0.0,2,0,0,0,0,0,10,5
ENG-Premier League,2425,Ipswich Town,Axel Tuanzebe,,,26.0,1997.0,19.0,31,19,21,4,6,17,26,65.4,9,21,10,11,23,54,56,1
ENG-Premier League,2425,Ipswich Town,Ben Godfrey,,,26.0,1998.0,1.8,1,0,1,0,0,1,1,100.0,0,1,1,0,2,3,3,0
ENG-Premier League,2425,Ipswich Town,Ben Johnson,,,24.0,2000.0,15.0,38,22,23,12,3,20,41,48.8,21,22,5,17,13,51,54,1
ENG-Premier League,2425,Ipswich Town,Cameron Burgess,,,28.0,1995.0,17.1,17,12,14,3,0,9,11,81.8,2,20,15,5,14,31,128,3
ENG-Premier League,2425,Ipswich Town,Chiedozie Ogbene,,,27.0,1997.0,2.6,7,3,1,2,4,2,4,50.0,2,1,0,1,1,8,3,0
ENG-Premier League,2425,Ipswich Town,Christian Walton,,,28.0,1995.0,7.0,0,0,0,0,0,0,1,0.0,1,0,0,0,0,0,2,1
ENG-Premier League,2425,Ipswich Town,Conor Chaplin,,,27.0,1997.0,9.5,15,5,6,6,3,6,14,42.9,8,8,1,7,4,19,3,0
ENG-Premier League,2425,Ipswich Town,Conor Townsend,,,31.0,1993.0,3.7,11,8,9,2,0,8,11,72.7,3,8,6,2,4,15,16,0
ENG-Premier League,2425,Ipswich Town,Dara O'Shea,,,25.0,1999.0,34.7,49,31,33,13,3,22,34,64.7,12,62,50,12,33,82,225,4
ENG-Premier League,2425,Ipswich Town,George Edmundson,,,26.0,1997.0,0.0,0,0,0,0,0,0,0,,0,0,0,0,0,0,0,0
ENG-Premier League,2425,Ipswich Town,George Hirst,,,25.0,1999.0,7.3,3,3,1,0,2,1,4,25.0,3,1,1,0,2,5,10,0
ENG-Premier League,2425,Ipswich Town,Harry Clarke,,,23.0,2001.0,4.2,5,3,3,2,0,3,6,50.0,3,5,4,1,4,9,14,3
ENG-Premier League,2425,Ipswich Town,Jack Clarke,,,23.0,2000.0,13.1,32,20,11,10,11,17,34,50.0,17,9,0,9,7,39,29,2
ENG-Premier League,2425,Ipswich Town,Jack Taylor,,,26.0,1998.0,9.6,20,10,6,11,3,12,27,44.4,15,12,3,9,9,29,24,0
ENG-Premier League,2425,Ipswich Town,Jacob Greaves,,,23.0,2000.0,24.5,40,21,20,17,3,22,35,62.9,13,41,26,15,21,61,148,3
ENG-Premier League,2425,Ipswich Town,Jaden Philogene Bidace,,,22.0,2002.0,5.3,14,7,6,6,2,8,15,53.3,7,11,1,10,10,24,9,1
ENG-Premier League,2425,Ipswich Town,Jens Cajuste,,,24.0,1999.0,21.8,44,22,19,23,2,21,49,42.9,28,25,10,15,28,72,33,2
ENG-Premier League,2425,Ipswich Town,Julio Enciso,,,20.0,2004.0,9.7,12,9,3,6,3,4,11,36.4,7,8,1,7,1,13,6,0
ENG-Premier League,2425,Ipswich Town,Kalvin Phillips,,,28.0,1995.0,13.7,35,19,8,20,7,15,39,38.5,24,35,6,29,19,54,37,2
ENG-Premier League,2425,Ipswich Town,Leif Davis,,,24.0,2000.0,30.5,46,27,33,9,4,30,48,62.5,18,25,8,17,25,71,77,3
ENG-Premier League,2425,Ipswich Town,Liam Delap,,,21.0,2003.0,28.8,11,8,3,3,5,2,15,13.3,13,8,0,8,2,13,28,0
ENG-Premier League,2425,Ipswich Town,Luke Woolfenden,,,25.0,1998.0,13.2,9,6,5,4,0,2,5,40.0,3,21,14,7,19,28,76,0
ENG-Premier League,2425,Ipswich Town,Marcus Harness,,,28.0,1996.0,0.5,1,0,0,0,1,0,3,0.0,3,2,1,1,0,1,1,0
ENG-Premier League,2425,Ipswich Town,Massimo Luongo,,,31.0,1992.0,2.2,9,6,6,2,1,5,8,62.5,3,4,2,2,2,11,2,0
ENG-Premier League,2425,Ipswich Town,Nathan Broadhead,,,26.0,1998.0,7.8,9,4,3,6,0,3,12,25.0,9,8,1,7,4,13,5,0
ENG-Premier League,2425,Ipswich Town,Omari Hutchinson,,,20.0,2003.0,28.7,32,13,14,10,8,13,48,27.1,35,27,2,25,11,43,15,1
ENG-Premier League,2425,Ipswich Town,Sam Morsy,,,32.0,1991.0,30.6,68,41,40,24,4,27,62,43.5,35,34,13,21,29,97,47,5
ENG-Premier League,2425,Ipswich Town,Sammie Szmodics,,,28.0,1995.0,11.0,16,10,4,10,2,7,26,26.9,19,10,2,8,6,22,14,0
ENG-Premier League,2425,Ipswich Town,Wes Burns,,,29.0,1994.0,10.3,13,11,1,9,3,4,10,40.0,6,7,2,5,10,23,13,2
ENG-Premier League,2425,Leicester City,Abdul Fatawu Issahaku,,,20.0,2004.0,6.4,21,15,13,2,6,11,19,57.9,8,7,0,7,4,25,12,0
ENG-Premier League,2425,Leicester City,Bilal El Khannouss,,,20.0,2004.0,24.2,50,30,16,29,5,17,32,53.1,15,22,4,18,6,56,10,3
ENG-Premier League,2425,Leicester City,Bobby De Cordova-Reid,,,31.0,1993.0,8.3,9,4,3,6,0,4,14,28.6,10,6,1,5,0,9,10,0
ENG-Premier League,2425,Leicester City,Boubakary Soumaré,,,25.0,1999.0,24.1,37,20,24,12,1,21,33,63.6,12,22,10,12,27,64,34,4
ENG-Premier League,2425,Leicester City,Caleb Okoli,,,23.0,2001.0,12.5,25,14,8,15,2,11,18,61.1,7,24,14,10,15,40,79,3
ENG-Premier League,2425,Leicester City,Conor Coady,,,31.0,1993.0,19.0,13,9,6,6,1,3,6,50.0,3,32,24,8,13,26,71,2
ENG-Premier League,2425,Leicester City,Danny Ward,,,31.0,1993.0,1.5,0,0,0,0,0,0,0,,0,0,0,0,0,0,1,0
ENG-Premier League,2425,Leicester City,Facundo Buonanotte,,,19.0,2004.0,16.9,53,32,17,22,14,21,67,31.3,46,34,6,28,12,65,14,0
ENG-Premier League,2425,Leicester City,Hamza Choudhury,,,26.0,1997.0,1.5,1,1,1,0,0,1,3,33.3,2,4,2,2,5,6,2,0
ENG-Premier League,2425,Leicester City,Harry Winks,,,28.0,1996.0,17.1,24,11,12,10,2,13,30,43.3,17,19,7,12,9,33,20,0
ENG-Premier League,2425,Leicester City,Jake Evans,,,,,0.3,1,1,0,0,1,0,1,0.0,1,0,0,0,0,1,1,0
ENG-Premier League,2425,Leicester City,Jakub Stolarczyk,,,23.0,2000.0,10.0,2,1,2,0,0,1,2,50.0,1,0,0,0,0,2,6,1
ENG-Premier League,2425,Leicester City,James Justin,,,26.0,1998.0,32.4,58,37,29,23,6,32,55,58.2,23,48,17,31,46,104,141,3
ENG-Premier League,2425,Leicester City,Jamie Vardy,,,37.0,1987.0,31.4,19,13,7,7,5,4,13,30.8,9,8,4,4,5,24,24,0
ENG-Premier League,2425,Leicester City,Jannik Vestergaard,,,31.0,1992.0,15.5,22,10,16,6,0,9,15,60.0,6,21,14,7,16,38,74,1
ENG-Premier League,2425,Leicester City,Jeremy Monga,,,,,1.2,2,1,0,1,1,1,1,100.0,0,3,2,1,0,2,1,0
ENG-Premier League,2425,Leicester City,Jordan Ayew,,,32.0,1991.0,18.2,27,15,8,14,5,7,23,30.4,16,21,2,19,12,39,19,0
ENG-Premier League,2425,Leicester City,Kasey McAteer,,,22.0,2001.0,9.5,23,16,11,9,3,14,29,48.3,15,18,2,16,5,28,15,0
ENG-Premier League,2425,Leicester City,Luke Thomas,,,23.0,2001.0,12.3,31,25,23,5,3,21,41,51.2,20,15,6,9,21,52,49,1
ENG-Premier League,2425,Leicester City,Mads Hermansen,,,24.0,2000.0,26.5,1,1,1,0,0,1,1,100.0,0,1,0,1,0,1,13,4
ENG-Premier League,2425,Leicester City,Michael Golding,,,18.0,2006.0,0.0,0,0,0,0,0,0,0,,0,0,0,0,0,0,0,0
ENG-Premier League,2425,Leicester City,Odsonne Édouard,,,26.0,1998.0,0.3,1,1,1,0,0,0,0,,0,0,0,0,0,1,1,0
ENG-Premier League,2425,Leicester City,Olabade Aluko,,,,,0.0,1,1,0,0,1,1,1,100.0,0,0,0,0,0,1,0,0
ENG-Premier League,2425,Leicester City,Oliver Skipp,,,23.0,2000.0,12.5,21,4,6,12,3,9,15,60.0,6,23,7,16,11,32,11,2
ENG-Premier League,2425,Leicester City,Patson Daka,,,25.0,1998.0,8.2,19,10,6,9,4,7,18,38.9,11,7,1,6,1,20,12,0
ENG-Premier League,2425,Leicester City,Ricardo Pereira,,,30.0,1993.0,4.3,13,8,4,6,3,7,14,50.0,7,8,3,5,4,17,11,0
ENG-Premier League,2425,Leicester City,Stephy Mavididi,,,26.0,1998.0,17.9,34,19,16,10,8,14,42,33.3,28,26,2,24,11,45,15,0
ENG-Premier League,2425,Leicester City,Victor Bernth Kristiansen,,,21.0,2002.0,27.6,87,51,56,26,5,49,91,53.8,42,38,15,23,42,129,75,3
ENG-Premier League,2425,Leicester City,Wilfred Ndidi,,,27.0,1996.0,25.8,85,51,45,32,8,30,61,49.2,31,47,19,28,31,116,80,0
ENG-Premier League,2425,Leicester City,Will Alves,,,19.0,2005.0,0.0,0,0,0,0,0,0,0,,0,0,0,0,0,0,0,0
ENG-Premier League,2425,Leicester City,Wout Faes,,,26.0,1998.0,31.3,42,26,26,14,2,25,48,52.1,23,48,35,13,26,68,185,4
ENG-Premier League,2425,Leicester City,Woyo Coulibaly,,,25.0,1999.0,1.2,6,4,4,2,0,2,2,100.0,0,3,1,2,5,11,1,0
ENG-Premier League,2425,Liverpool,Alexis Mac Allister,,,25.0,1998.0,28.9,95,58,28,51,16,55,104,52.9,49,61,6,55,22,117,29,1
ENG-Premier League,2425,Liverpool,Alisson,,,31.0,1992.0,27.9,1,0,1,0,0,0,1,0.0,1,0,0,0,0,1,13,1
ENG-Premier League,2425,Liverpool,Andrew Robertson,,,30.0,1994.0,27.6,39,22,25,10,4,31,51,60.8,20,10,4,6,21,60,54,2
ENG-Premier League,2425,Liverpool,Caoimhín Kelleher,,,25.0,1998.0,10.0,0,0,0,0,0,0,0,,0,0,0,0,0,0,1,2
ENG-Premier League,2425,Liverpool,Cody Gakpo,,,25.0,1999.0,21.5,28,16,6,13,9,13,25,52.0,12,23,3,20,12,40,19,1
ENG-Premier League,2425,Liverpool,Conor Bradley,,,21.0,2003.0,8.4,14,10,7,5,2,11,22,50.0,11,9,2,7,4,18,31,0
ENG-Premier League,2425,Liverpool,Curtis Jones,,,23.0,2001.0,19.0,39,22,6,23,10,17,27,63.0,10,22,9,13,7,46,10,3
ENG-Premier League,2425,Liverpool,Darwin Núñez,,,25.0,1999.0,12.6,21,18,11,4,6,7,18,38.9,11,6,0,6,4,25,12,0
ENG-Premier League,2425,Liverpool,Diogo Jota,,,27.0,1996.0,13.3,14,8,2,8,4,7,19,36.8,12,9,0,9,8,22,6,0
ENG-Premier League,2425,Liverpool,Dominik Szoboszlai,,,23.0,2000.0,27.7,38,20,14,19,5,17,45,37.8,28,39,5,34,9,47,19,2
ENG-Premier League,2425,Liverpool,Federico Chiesa,,,26.0,1997.0,1.2,1,0,0,1,0,0,2,0.0,2,1,0,1,0,1,1,1
ENG-Premier League,2425,Liverpool,Harvey Elliott,,,21.0,2003.0,4.1,5,3,3,1,1,2,8,25.0,6,7,2,5,1,6,3,1
ENG-Premier League,2425,Liverpool,Ibrahima Konaté,,,25.0,1999.0,28.4,40,26,25,13,2,25,35,71.4,10,29,15,14,17,57,133,3
ENG-Premier League,2425,Liverpool,Jarell Quansah,,,21.0,2003.0,5.5,12,8,8,4,0,7,10,70.0,3,10,7,3,7,19,28,1
ENG-Premier League,2425,Liverpool,Jayden Danns,,,18.0,2006.0,0.1,0,0,0,0,0,0,1,0.0,1,0,0,0,0,0,0,0
ENG-Premier League,2425,Liverpool,Joe Gomez,,,27.0,1997.0,5.8,13,10,5,7,1,11,16,68.8,5,9,6,3,7,20,20,2
ENG-Premier League,2425,Liverpool,Kostas Tsimikas,,,28.0,1996.0,9.3,31,20,15,11,5,14,23,60.9,9,5,2,3,11,42,20,0
ENG-Premier League,2425,Liverpool,Luis Díaz,,,27.0,1997.0,26.7,39,26,13,20,6,15,39,38.5,24,19,0,19,7,46,7,1
ENG-Premier League,2425,Liverpool,Mohamed Salah,,,32.0,1992.0,37.5,21,11,7,5,9,8,17,47.1,9,12,0,12,9,30,5,0
ENG-Premier League,2425,Liverpool,Ryan Gravenberch,,,22.0,2002.0,35.1,69,35,27,29,13,32,56,57.1,24,35,10,25,60,129,59,2
ENG-Premier League,2425,Liverpool,Trent Alexander-Arnold,,,25.0,1998.0,26.3,72,50,44,19,9,49,105,46.7,56,26,9,17,31,103,55,4
ENG-Premier League,2425,Liverpool,Virgil van Dijk,,,33.0,1991.0,37.0,38,20,17,19,2,13,22,59.1,9,27,16,11,56,94,190,4
ENG-Premier League,2425,Liverpool,Vitezslav Jaros,,,23.0,2001.0,0.1,0,0,0,0,0,0,0,,0,0,0,0,0,0,0,0
ENG-Premier League,2425,Liverpool,Wataru Endo,,,31.0,1993.0,3.0,12,8,7,5,0,6,10,60.0,4,8,1,7,6,18,9,0
ENG-Premier League,2425,Manchester City,Abdukodir Khusanov,,,20.0,2004.0,5.6,5,4,4,1,0,2,3,66.7,1,5,4,1,3,8,29,1
ENG-Premier League,2425,Manchester City,Bernardo Silva,,,29.0,1994.0,29.7,56,37,17,30,9,25,56,44.6,31,36,7,29,23,79,32,3
ENG-Premier League,2425,Manchester City,Claudio Echeverri,,,18.0,2006.0,0.1,1,0,0,1,0,1,1,100.0,0,0,0,0,0,1,0,0
ENG-Premier League,2425,Manchester City,Divin Mubama,,,19.0,2004.0,0.3,0,0,0,0,0,0,0,,0,0,0,0,0,0,0,0
ENG-Premier League,2425,Manchester City,Ederson,,,30.0,1993.0,25.8,0,0,0,0,0,0,2,0.0,2,0,0,0,1,1,11,4
ENG-Premier League,2425,Manchester City,Erling Haaland,,,24.0,2000.0,30.4,11,6,3,3,5,3,8,37.5,5,12,1,11,5,16,23,0
ENG-Premier League,2425,Manchester City,Jack Grealish,,,28.0,1995.0,8.0,9,5,4,2,3,2,5,40.0,3,12,2,10,2,11,6,1
ENG-Premier League,2425,Manchester City,Jahmai Simpson-Pusey,,,18.0,2005.0,1.1,1,0,1,0,0,0,1,0.0,1,1,1,0,0,1,2,0
ENG-Premier League,2425,Manchester City,James Mcatee,,,21.0,2002.0,3.9,5,2,0,4,1,1,7,14.3,6,8,0,8,2,7,1,0
ENG-Premier League,2425,Manchester City,Jeremy Doku,,,22.0,2002.0,16.8,31,22,9,12,10,8,15,53.3,7,11,1,10,4,35,2,0
ENG-Premier League,2425,Manchester City,John Stones,,,30.0,1994.0,6.1,6,2,3,2,1,5,5,100.0,0,5,3,2,4,10,19,1
ENG-Premier League,2425,Manchester City,Joško Gvardiol,,,22.0,2002.0,36.4,58,39,25,21,12,21,40,52.5,19,42,20,22,44,102,122,8
ENG-Premier League,2425,Manchester City,Kevin De Bruyne,,,33.0,1991.0,18.9,17,9,7,5,5,5,23,21.7,18,8,0,8,7,24,10,1
ENG-Premier League,2425,Manchester City,Kyle Walker,,,34.0,1990.0,10.8,17,10,7,7,3,14,26,53.8,12,13,4,9,3,20,13,1
ENG-Premier League,2425,Manchester City,Manuel Akanji,,,29.0,1995.0,22.4,19,12,12,4,3,11,17,64.7,6,11,8,3,9,28,64,3
ENG-Premier League,2425,Manchester City,Mateo Kovačić,,,30.0,1994.0,24.4,69,38,23,38,8,31,65,47.7,34,20,0,20,24,93,21,1
ENG-Premier League,2425,Manchester City,Matheus Nunes,,,25.0,1998.0,18.6,35,22,15,14,6,16,38,42.1,22,17,4,13,15,50,38,2
ENG-Premier League,2425,Manchester City,Nathan Aké,,,29.0,1995.0,7.5,9,7,7,2,0,4,6,66.7,2,7,2,5,3,12,22,1
ENG-Premier League,2425,Manchester City,Nico O’Reilly,,,19.0,2005.0,5.9,9,4,3,3,3,4,8,50.0,4,5,1,4,4,13,12,0
ENG-Premier League,2425,Manchester City,Nicolás González,,,22.0,2002.0,8.4,16,6,5,7,4,6,11,54.5,5,9,0,9,8,24,21,0
ENG-Premier League,2425,Manchester City,Omar Marmoush,,,25.0,1999.0,13.1,13,8,2,9,2,8,16,50.0,8,15,1,14,6,19,3,0
ENG-Premier League,2425,Manchester City,Oscar Bobb,,,21.0,2003.0,0.2,0,0,0,0,0,0,0,,0,0,0,0,0,0,0,0
ENG-Premier League,2425,Manchester City,Phil Foden,,,24.0,2000.0,19.7,13,5,5,4,4,7,18,38.9,11,13,1,12,9,22,7,1
ENG-Premier League,2425,Manchester City,Rico Lewis,,,19.0,2004.0,21.0,30,19,13,12,5,13,21,61.9,8,28,7,21,13,43,45,1
ENG-Premier League,2425,Manchester City,Rodri,,,28.0,1996.0,0.8,2,1,1,1,0,0,0,,0,1,0,1,1,3,1,0
ENG-Premier League,2425,Manchester City,Rúben Dias,,,27.0,1997.0,25.2,17,11,7,9,1,7,13,53.8,6,23,20,3,20,37,71,4
ENG-Premier League,2425,Manchester City,Stefan Ortega,,,31.0,1992.0,12.2,0,0,0,0,0,0,1,0.0,1,0,0,0,0,0,11,1
ENG-Premier League,2425,Manchester City,Sávio,,,20.0,2004.0,19.6,23,17,5,10,8,10,19,52.6,9,14,2,12,6,29,9,1
ENG-Premier League,2425,Manchester City,Vitor Reis,,,18.0,2006.0,0.0,0,0,0,0,0,0,0,,0,0,0,0,0,0,1,0
ENG-Premier League,2425,Manchester City,İlkay Gündoğan,,,33.0,1990.0,24.7,25,13,5,15,5,10,24,41.7,14,15,0,15,13,38,23,0
ENG-Premier League,2425,Manchester Utd,Alejandro Garnacho,,,20.0,2004.0,24.4,30,18,11,6,13,12,37,32.4,25,19,0,19,13,43,11,2
ENG-Premier League,2425,Manchester Utd,Altay Bayındır,,,26.0,1998.0,4.0,0,0,0,0,0,0,1,0.0,1,0,0,0,0,0,9,1
ENG-Premier League,2425,Manchester Utd,Amad Diallo,,,22.0,2002.0,21.1,38,31,9,20,9,19,32,59.4,13,15,2,13,11,49,19,1
ENG-Premier League,2425,Manchester Utd,André Onana,,,28.0,1996.0,34.0,2,2,2,0,0,2,4,50.0,2,0,0,0,0,2,11,4
ENG-Premier League,2425,Manchester Utd,Antony,,,24.0,2000.0,1.6,6,3,4,2,0,2,5,40.0,3,2,0,2,2,8,0,0
ENG-Premier League,2425,Manchester Utd,Ayden Heaven,,,17.0,2006.0,1.9,4,3,1,3,0,2,2,100.0,0,2,2,0,4,8,9,0
ENG-Premier League,2425,Manchester Utd,Bruno Fernandes,,,29.0,1994.0,33.5,84,50,27,38,19,34,85,40.0,51,35,6,29,26,110,35,3
ENG-Premier League,2425,Manchester Utd,Casemiro,,,32.0,1992.0,16.6,83,50,50,23,10,45,74,60.8,29,39,10,29,14,97,51,3
ENG-Premier League,2425,Manchester Utd,Chidozie Obi-Martin,,,16.0,2007.0,1.8,2,1,0,0,2,2,2,100.0,0,0,0,0,0,2,1,0
ENG-Premier League,2425,Manchester Utd,Christian Eriksen,,,32.0,1992.0,11.8,19,9,4,12,3,11,27,40.7,16,15,5,10,7,26,8,0
ENG-Premier League,2425,Manchester Utd,Diogo Dalot,,,25.0,1999.0,31.3,68,40,40,22,6,34,52,65.4,18,22,9,13,37,105,72,0
ENG-Premier League,2425,Manchester Utd,Harry Amass,,,17.0,2007.0,3.8,6,2,5,1,0,2,8,25.0,6,11,1,10,2,8,11,0
ENG-Premier League,2425,Manchester Utd,Harry Maguire,,,31.0,1993.0,19.5,30,15,23,6,1,17,23,73.9,6,15,12,3,40,70,78,1
ENG-Premier League,2425,Manchester Utd,Jonny Evans,,,36.0,1988.0,3.5,8,6,4,4,0,3,6,50.0,3,3,2,1,5,13,15,0
ENG-Premier League,2425,Manchester Utd,Joshua Zirkzee,,,23.0,2001.0,15.6,14,8,3,8,3,5,10,50.0,5,15,4,11,6,20,8,1
ENG-Premier League,2425,Manchester Utd,Kobbie Mainoo,,,19.0,2005.0,18.3,46,29,18,14,14,24,40,60.0,16,16,2,14,19,65,14,1
ENG-Premier League,2425,Manchester Utd,Leny Yoro,,,18.0,2005.0,12.9,29,11,19,9,1,13,19,68.4,6,5,3,2,18,47,43,0
ENG-Premier League,2425,Manchester Utd,Lisandro Martínez,,,26.0,1998.0,19.5,40,24,25,12,3,21,36,58.3,15,22,8,14,32,72,57,1
ENG-Premier League,2425,Manchester Utd,Luke Shaw,,,29.0,1995.0,3.9,4,3,2,2,0,2,2,100.0,0,6,1,5,2,6,7,0
ENG-Premier League,2425,Manchester Utd,Manuel Ugarte Ribeiro,,,23.0,2001.0,19.8,77,49,34,34,9,30,68,44.1,38,33,4,29,27,104,17,2
ENG-Premier League,2425,Manchester Utd,Marcus Rashford,,,26.0,1997.0,10.9,7,4,2,2,3,3,9,33.3,6,8,0,8,4,11,7,0
ENG-Premier League,2425,Manchester Utd,Mason Mount,,,25.0,1999.0,6.9,15,5,5,8,2,9,12,75.0,3,11,1,10,4,19,4,0
ENG-Premier League,2425,Manchester Utd,Matthijs de Ligt,,,24.0,1999.0,23.6,30,22,17,12,1,23,32,71.9,9,29,21,8,33,63,96,0
ENG-Premier League,2425,Manchester Utd,Noussair Mazraoui,,,26.0,1997.0,31.5,115,68,58,42,15,59,94,62.8,35,36,9,27,34,149,95,1
ENG-Premier League,2425,Manchester Utd,Patrick Dorgu,,,19.0,2004.0,9.4,31,24,15,14,2,16,23,69.6,7,11,0,11,4,35,23,2
ENG-Premier League,2425,Manchester Utd,Rasmus Højlund,,,21.0,2003.0,22.3,3,1,0,2,1,0,5,0.0,5,6,0,6,2,5,6,0
ENG-Premier League,2425,Manchester Utd,Scott McTominay,,,27.0,1996.0,0.2,0,0,0,0,0,0,1,0.0,1,0,0,0,0,0,1,0
ENG-Premier League,2425,Manchester Utd,Toby Collyer,,,20.0,2004.0,2.0,12,9,6,6,0,5,6,83.3,1,2,1,1,2,14,3,0
ENG-Premier League,2425,Manchester Utd,Tyler Fredricson,,,19.0,2005.0,1.8,5,3,3,2,0,1,2,50.0,1,2,0,2,1,6,11,0
ENG-Premier League,2425,Manchester Utd,Tyrell Malacia,,,24.0,1999.0,1.1,2,1,2,0,0,1,2,50.0,1,0,0,0,1,3,1,1
ENG-Premier League,2425,Manchester Utd,Victor Lindelöf,,,30.0,1994.0,7.8,7,2,5,1,1,3,4,75.0,1,6,4,2,8,15,36,2
ENG-Premier League,2425,Newcastle Utd,Alexander Isak,,,24.0,1999.0,30.6,12,5,2,3,7,5,15,33.3,10,18,2,16,3,15,17,1
ENG-Premier League,2425,Newcastle Utd,Anthony Gordon,,,23.0,2001.0,27.0,32,18,9,18,5,12,37,32.4,25,25,2,23,7,39,9,3
ENG-Premier League,2425,Newcastle Utd,Bruno Guimarães,,,26.0,1997.0,36.3,83,47,41,30,12,33,69,47.8,36,36,10,26,29,112,44,5
ENG-Premier League,2425,Newcastle Utd,Callum Wilson,,,32.0,1992.0,4.1,2,2,0,1,1,0,2,0.0,2,2,0,2,1,3,1,0
ENG-Premier League,2425,Newcastle Utd,Dan Burn,,,32.0,1992.0,37.0,39,24,22,15,2,20,36,55.6,16,36,26,10,27,66,197,4
ENG-Premier League,2425,Newcastle Utd,Emil Krafth,,,29.0,1994.0,3.8,4,2,2,1,1,2,3,66.7,1,5,4,1,2,6,16,0
ENG-Premier League,2425,Newcastle Utd,Fabian Schär,,,32.0,1991.0,32.6,36,21,16,18,2,14,35,40.0,21,38,25,13,45,81,138,3
ENG-Premier League,2425,Newcastle Utd,Harvey Barnes,,,26.0,1997.0,19.5,16,9,4,6,6,3,11,27.3,8,8,2,6,6,22,15,1
ENG-Premier League,2425,Newcastle Utd,Jacob Murphy,,,29.0,1995.0,26.2,28,19,10,12,6,20,44,45.5,24,31,0,31,13,41,35,1
ENG-Premier League,2425,Newcastle Utd,Joe Willock,,,24.0,1999.0,12.1,30,17,15,12,3,18,31,58.1,13,24,6,18,6,36,7,0
ENG-Premier League,2425,Newcastle Utd,Joelinton,,,27.0,1996.0,26.6,57,35,23,23,11,25,44,56.8,19,37,7,30,23,80,47,2
ENG-Premier League,2425,Newcastle Utd,Kieran Trippier,,,33.0,1990.0,14.5,38,21,18,14,6,22,36,61.1,14,11,3,8,12,50,49,0
ENG-Premier League,2425,Newcastle Utd,Lewis Hall,,,19.0,2004.0,24.3,58,41,28,22,8,40,74,54.1,34,33,18,15,18,76,75,3
ENG-Premier League,2425,Newcastle Utd,Lewis Miley,,,18.0,2006.0,3.5,14,11,5,7,2,7,14,50.0,7,5,1,4,2,16,5,2
ENG-Premier League,2425,Newcastle Utd,Lloyd Kelly,,,25.0,1998.0,3.4,5,4,4,1,0,1,1,100.0,0,6,4,2,1,6,17,0
ENG-Premier League,2425,Newcastle Utd,Martin Dúbravka,,,35.0,1989.0,10.0,0,0,0,0,0,0,0,,0,0,0,0,0,0,3,0
ENG-Premier League,2425,Newcastle Utd,Matt Targett,,,28.0,1995.0,0.2,0,0,0,0,0,0,1,0.0,1,0,0,0,1,1,1,0
ENG-Premier League,2425,Newcastle Utd,Miguel Almirón,,,30.0,1994.0,1.7,3,2,2,0,1,2,3,66.7,1,2,0,2,0,3,0,0
ENG-Premier League,2425,Newcastle Utd,Nick Pope,,,32.0,1992.0,28.0,0,0,0,0,0,0,0,,0,1,0,1,1,1,32,5
ENG-Premier League,2425,Newcastle Utd,Sandro Tonali,,,24.0,2000.0,29.2,51,32,22,23,6,25,51,49.0,26,34,11,23,34,85,33,2
ENG-Premier League,2425,Newcastle Utd,Sean Longstaff,,,26.0,1997.0,8.9,27,16,10,9,8,18,27,66.7,9,17,5,12,7,34,8,0
ENG-Premier League,2425,Newcastle Utd,Sven Botman,,,24.0,2000.0,4.6,12,9,6,5,1,7,9,77.8,2,5,4,1,5,17,25,1
ENG-Premier League,2425,Newcastle Utd,Valentino Livramento,,,21.0,2002.0,31.6,54,36,35,15,4,32,59,54.2,27,37,11,26,23,77,108,1
ENG-Premier League,2425,Newcastle Utd,William Osula,,,20.0,2003.0,1.5,2,0,1,0,1,0,2,0.0,2,0,0,0,4,6,2,0
ENG-Premier League,2425,Nott'ham Forest,Anthony Elanga,,,22.0,2002.0,27.8,19,14,8,8,3,5,17,29.4,12,11,1,10,6,25,25,0
ENG-Premier League,2425,Nott'ham Forest,Callum Hudson-Odoi,,,23.0,2000.0,24.4,22,14,8,8,6,12,18,66.7,6,11,0,11,13,35,12,1
ENG-Premier League,2425,Nott'ham Forest,Chris Wood,,,32.0,1991.0,32.9,6,5,2,2,2,3,11,27.3,8,12,7,5,5,11,29,1
ENG-Premier League,2425,Nott'ham Forest,Danilo,,,23.0,2001.0,3.1,8,4,7,1,0,3,6,50.0,3,2,1,1,4,12,3,0
ENG-Premier League,2425,Nott'ham Forest,Elliot Anderson,,,21.0,2002.0,30.3,92,56,54,29,9,48,111,43.2,63,48,9,39,31,123,76,4
ENG-Premier League,2425,Nott'ham Forest,Eric da Silva Moreira,,,18.0,2006.0,0.3,2,2,2,0,0,2,6,33.3,4,0,0,0,1,3,0,0
ENG-Premier League,2425,Nott'ham Forest,Harry Toffolo,,,28.0,1995.0,1.5,5,3,3,1,1,3,4,75.0,1,2,2,0,2,7,12,0
ENG-Premier League,2425,Nott'ham Forest,Ibrahim Sangaré,,,26.0,1997.0,6.6,28,14,8,17,3,8,17,47.1,9,10,4,6,6,34,13,1
ENG-Premier League,2425,Nott'ham Forest,James Ward-Prowse,,,29.0,1994.0,4.4,4,1,1,3,0,2,2,100.0,0,3,2,1,5,9,8,0
ENG-Premier League,2425,Nott'ham Forest,Jota Silva,,,24.0,1999.0,9.5,27,14,12,13,2,6,27,22.2,21,9,1,8,12,39,17,0
ENG-Premier League,2425,Nott'ham Forest,Matz Sels,,,32.0,1992.0,38.0,1,1,1,0,0,1,1,100.0,0,0,0,0,0,1,26,1
ENG-Premier League,2425,Nott'ham Forest,Morato,,,23.0,2001.0,10.1,22,14,18,3,1,13,21,61.9,8,14,5,9,10,32,78,2
ENG-Premier League,2425,Nott'ham Forest,Morgan Gibbs-White,,,24.0,2000.0,31.1,43,22,14,23,6,17,33,51.5,16,18,5,13,23,66,29,1
ENG-Premier League,2425,Nott'ham Forest,Murillo,,,22.0,2002.0,35.4,53,36,38,12,3,27,46,58.7,19,69,45,24,36,89,249,3
ENG-Premier League,2425,Nott'ham Forest,Neco Williams,,,23.0,2001.0,28.8,90,57,63,19,8,53,86,61.6,33,42,10,32,31,121,137,3
ENG-Premier League,2425,Nott'ham Forest,Nicolás Domínguez,,,26.0,1998.0,21.8,86,45,40,35,11,36,76,47.4,40,38,12,26,29,115,54,1
ENG-Premier League,2425,Nott'ham Forest,Nikola Milenković,,,26.0,1997.0,37.0,51,29,36,13,2,27,34,79.4,7,41,24,17,27,78,209,1
ENG-Premier League,2425,Nott'ham Forest,Ola Aina,,,27.0,1996.0,33.3,55,42,39,15,1,36,64,56.3,28,34,12,22,33,88,115,4
ENG-Premier League,2425,Nott'ham Forest,Ramón Sosa,,,24.0,1999.0,3.3,5,3,3,0,2,1,5,20.0,4,9,0,9,4,9,5,0
ENG-Premier League,2425,Nott'ham Forest,Ryan Yates,,,26.0,1997.0,21.3,42,21,24,14,4,17,37,45.9,20,38,10,28,26,68,61,1
ENG-Premier League,2425,Nott'ham Forest,Taiwo Awoniyi,,,26.0,1997.0,4.6,6,3,0,3,3,4,5,80.0,1,1,0,1,0,6,7,0
ENG-Premier League,2425,Nott'ham Forest,Willy Boly,,,33.0,1991.0,1.7,6,1,5,1,0,4,4,100.0,0,4,2,2,3,9,12,0
ENG-Premier League,2425,Nott'ham Forest,Álex Moreno,,,31.0,1993.0,10.6,25,18,20,5,0,15,39,38.5,24,11,5,6,15,40,43,0
ENG-Premier League,2425,Southampton,Aaron Ramsdale,,,26.0,1998.0,30.0,0,0,0,0,0,0,3,0.0,3,0,0,0,2,2,10,3
ENG-Premier League,2425,Southampton,Adam Armstrong,,,27.0,1997.0,13.9,12,3,2,7,3,3,14,21.4,11,6,1,5,3,15,8,0
ENG-Premier League,2425,Southampton,Adam Lallana,,,36.0,1988.0,4.0,8,5,4,4,0,2,12,16.7,10,4,1,3,5,13,5,0
ENG-Premier League,2425,Southampton,Albert Grønbaek,,,23.0,2001.0,1.6,4,1,1,1,2,3,10,30.0,7,1,1,0,0,4,1,0
ENG-Premier League,2425,Southampton,Alex McCarthy,,,34.0,1989.0,5.0,0,0,0,0,0,0,0,,0,0,0,0,0,0,1,4
ENG-Premier League,2425,Southampton,Armel Bella Kotchap,,,22.0,2001.0,3.7,7,5,5,2,0,3,6,50.0,3,2,2,0,5,12,21,1
ENG-Premier League,2425,Southampton,Ben Brereton,,,25.0,1999.0,5.0,3,2,0,2,1,1,9,11.1,8,2,1,1,0,3,4,0
ENG-Premier League,2425,Southampton,Cameron Archer,,,23.0,2001.0,16.0,13,8,8,3,2,2,9,22.2,7,5,1,4,2,15,11,0
ENG-Premier League,2425,Southampton,Carlos Alcaraz,,,21.0,2002.0,0.1,0,0,0,0,0,0,0,,0,0,0,0,1,1,0,0
ENG-Premier League,2425,Southampton,Charlie Taylor,,,30.0,1993.0,4.0,7,5,4,3,0,5,7,71.4,2,8,5,3,5,12,31,1
ENG-Premier League,2425,Southampton,Flynn Downes,,,25.0,1999.0,23.9,49,25,23,21,5,15,36,41.7,21,28,9,19,32,81,51,4
ENG-Premier League,2425,Southampton,Jack Stephens,,,30.0,1994.0,15.4,34,20,25,9,0,17,30,56.7,13,20,13,7,13,47,53,2
ENG-Premier League,2425,Southampton,James Bree,,,26.0,1997.0,11.9,19,14,8,10,1,10,25,40.0,15,10,3,7,9,28,29,0
ENG-Premier League,2425,Southampton,Jan Bednarek,,,28.0,1996.0,28.1,36,19,23,13,0,16,31,51.6,15,47,36,11,56,92,190,5
ENG-Premier League,2425,Southampton,Jay Robinson,,,17.0,2007.0,1.5,4,1,3,0,1,1,1,100.0,0,0,0,0,0,4,1,0
ENG-Premier League,2425,Southampton,Joachim Kayi Sanda,,,17.0,2006.0,0.2,0,0,0,0,0,0,0,,0,0,0,0,2,2,0,0
ENG-Premier League,2425,Southampton,Joe Aribo,,,28.0,1996.0,22.4,47,33,17,24,6,17,35,48.6,18,28,11,17,20,67,32,3
ENG-Premier League,2425,Southampton,Joe Lumley,,,29.0,1995.0,3.0,0,0,0,0,0,0,0,,0,0,0,0,0,0,3,3
ENG-Premier League,2425,Southampton,Kamaldeen Sulemana,,,22.0,2002.0,15.6,22,17,9,5,8,10,15,66.7,5,16,4,12,6,28,9,0
ENG-Premier League,2425,Southampton,Kyle Walker-Peters,,,27.0,1997.0,32.4,44,29,22,15,7,16,35,45.7,19,27,15,12,19,63,90,1
ENG-Premier League,2425,Southampton,Lesley Ugochukwu,,,20.0,2004.0,18.4,50,24,16,30,4,18,36,50.0,18,27,10,17,14,64,23,2
ENG-Premier League,2425,Southampton,Mateus Fernandes,,,20.0,2004.0,32.3,89,48,45,28,16,33,72,45.8,39,43,8,35,28,117,35,7
ENG-Premier League,2425,Southampton,Maxwel Cornet,,,27.0,1996.0,0.8,5,5,1,4,0,0,4,0.0,4,0,0,0,0,5,2,0
ENG-Premier League,2425,Southampton,Nathan Wood-Gordon,,,22.0,2002.0,8.6,14,8,8,5,1,8,11,72.7,3,9,6,3,5,19,39,2
ENG-Premier League,2425,Southampton,Paul Onuachu,,,30.0,1994.0,11.7,7,2,1,5,1,3,7,42.9,4,7,2,5,1,8,16,1
ENG-Premier League,2425,Southampton,Ronnie Edwards,,,21.0,2003.0,0.1,0,0,0,0,0,0,0,,0,1,1,0,0,0,0,0
ENG-Premier League,2425,Southampton,Ross Stewart,,,28.0,1996.0,4.3,6,4,1,1,4,3,8,37.5,5,3,0,3,1,7,7,0
ENG-Premier League,2425,Southampton,Ryan Fraser,,,30.0,1994.0,3.4,6,2,2,4,0,4,6,66.7,2,1,1,0,1,7,9,0
ENG-Premier League,2425,Southampton,Ryan Manning,,,28.0,1996.0,16.2,28,17,16,10,2,14,26,53.8,12,20,11,9,17,45,47,0
ENG-Premier League,2425,Southampton,Samuel Amo-Ameyaw,,,18.0,2006.0,0.3,1,0,0,1,0,1,1,100.0,0,0,0,0,0,1,0,0
ENG-Premier League,2425,Southampton,Samuel Edozie,,,21.0,2003.0,0.7,3,1,0,1,2,2,2,100.0,0,0,0,0,0,3,0,0
ENG-Premier League,2425,Southampton,Taylor Harwood-Bellis,,,22.0,2002.0,31.4,28,20,13,12,3,19,35,54.3,16,65,43,22,30,58,141,6
ENG-Premier League,2425,Southampton,Tyler Dibling,,,18.0,2006.0,20.8,34,20,13,18,3,16,26,61.5,10,19,5,14,8,42,16,1
ENG-Premier League,2425,Southampton,Welington,,,23.0,2001.0,5.4,21,9,15,5,1,12,19,63.2,7,5,1,4,7,28,36,0
ENG-Premier League,2425,Southampton,William Smallbone,,,24.0,2000.0,7.7,20,13,9,9,2,7,22,31.8,15,8,0,8,2,22,14,2
ENG-Premier League,2425,Southampton,Yukinari Sugawara,,,24.0,2000.0,17.3,31,18,16,14,1,19,31,61.3,12,21,10,11,11,42,53,3
ENG-Premier League,2425,Tottenham,Alfie Dorrington,,,19.0,2005.0,0.2,0,0,0,0,0,0,0,,0,0,0,0,0,0,0,0
ENG-Premier League,2425,Tottenham,Antonín Kinský,,,21.0,2003.0,6.0,3,1,3,0,0,1,1,100.0,0,0,0,0,0,3,9,1
ENG-Premier League,2425,Tottenham,Archie Gray,,,18.0,2006.0,19.5,16,8,4,8,4,7,17,41.2,10,22,11,11,19,35,50,2
ENG-Premier League,2425,Tottenham,Ben Davies,,,31.0,1993.0,14.8,17,11,8,8,1,9,17,52.9,8,28,19,9,12,29,81,1
ENG-Premier League,2425,Tottenham,Brandon Austin,,,25.0,1999.0,1.0,0,0,0,0,0,0,0,,0,0,0,0,0,0,1,0
ENG-Premier League,2425,Tottenham,Brennan Johnson,,,23.0,2001.0,24.2,39,26,9,20,10,16,34,47.1,18,25,3,22,4,43,14,0
ENG-Premier League,2425,Tottenham,Cristian Romero,,,26.0,1998.0,15.7,35,29,26,8,1,21,30,70.0,9,18,3,15,21,56,57,2
ENG-Premier League,2425,Tottenham,Dane Scarlett,,,20.0,2004.0,0.4,1,0,0,1,0,0,0,,0,0,0,0,0,1,1,0
ENG-Premier League,2425,Tottenham,Dejan Kulusevski,,,24.0,2000.0,26.5,45,23,17,13,15,19,51,37.3,32,34,5,29,13,58,10,1
ENG-Premier League,2425,Tottenham,Destiny Udogie,,,21.0,2002.0,21.4,75,47,42,26,7,33,48,68.8,15,40,6,34,22,97,36,1
ENG-Premier League,2425,Tottenham,Djed Spence,,,23.0,2000.0,19.9,47,34,25,15,7,23,30,76.7,7,28,9,19,21,68,74,2
ENG-Premier League,2425,Tottenham,Dominic Solanke,,,26.0,1997.0,24.5,18,11,1,12,5,4,16,25.0,12,20,9,11,1,19,23,0
ENG-Premier League,2425,Tottenham,Fraser Forster,,,36.0,1988.0,7.0,0,0,0,0,0,0,1,0.0,1,0,0,0,0,0,7,3
ENG-Premier League,2425,Tottenham,Guglielmo Vicario,,,27.0,1996.0,24.0,0,0,0,0,0,0,0,,0,0,0,0,1,1,14,6
ENG-Premier League,2425,Tottenham,James Maddison,,,27.0,1996.0,20.1,31,19,8,16,7,9,29,31.0,20,15,4,11,12,43,19,1
ENG-Premier League,2425,Tottenham,Kevin Danso,,,25.0,1998.0,9.4,7,5,4,3,0,6,11,54.5,5,15,14,1,6,13,71,1
ENG-Premier League,2425,Tottenham,Lucas Bergvall,,,18.0,2006.0,13.5,39,19,14,20,5,17,32,53.1,15,18,8,10,24,63,22,3
ENG-Premier League,2425,Tottenham,Mathys Tel,,,19.0,2005.0,10.1,16,6,5,6,5,5,13,38.5,8,8,1,7,2,18,8,2
ENG-Premier League,2425,Tottenham,Micky van de Ven,,,23.0,2001.0,11.3,10,6,5,4,1,8,14,57.1,6,12,8,4,10,20,39,1
ENG-Premier League,2425,Tottenham,Mikey Moore,,,16.0,2007.0,4.1,2,1,2,0,0,0,4,0.0,4,2,0,2,1,3,4,0
ENG-Premier League,2425,Tottenham,Pape Matar Sarr,,,21.0,2002.0,21.3,49,36,19,23,7,12,25,48.0,13,26,10,16,30,79,25,1
ENG-Premier League,2425,Tottenham,Pedro Porro,,,24.0,1999.0,29.0,66,49,34,22,10,44,77,57.1,33,44,17,27,36,102,84,2
ENG-Premier League,2425,Tottenham,Radu Drăgușin,,,22.0,2002.0,13.9,10,6,8,2,0,6,12,50.0,6,22,16,6,15,25,49,4
ENG-Premier League,2425,Tottenham,Richarlison,,,27.0,1997.0,5.6,5,3,0,4,1,0,3,0.0,3,1,1,0,0,5,8,0
ENG-Premier League,2425,Tottenham,Rodrigo Bentancur,,,27.0,1997.0,18.3,40,22,19,17,4,19,40,47.5,21,25,8,17,40,80,38,1
ENG-Premier League,2425,Tottenham,Sergio Reguilón,,,27.0,1996.0,2.2,4,3,1,3,0,2,5,40.0,3,7,0,7,4,8,8,0
ENG-Premier League,2425,Tottenham,Son Heung-min,,,32.0,1992.0,23.4,17,9,3,8,6,5,27,18.5,22,11,0,11,5,22,17,1
ENG-Premier League,2425,Tottenham,Timo Werner,,,28.0,1996.0,5.7,6,4,3,3,0,3,13,23.1,10,10,1,9,1,7,7,0
ENG-Premier League,2425,Tottenham,Will Lankshear,,,19.0,2005.0,0.1,0,0,0,0,0,0,0,,0,0,0,0,0,0,0,0
ENG-Premier League,2425,Tottenham,Wilson Odobert,,,19.0,2004.0,9.4,14,5,5,4,5,8,14,57.1,6,6,0,6,4,18,5,1
ENG-Premier League,2425,Tottenham,Yves Bissouma,,,27.0,1996.0,15.6,49,31,20,25,4,19,34,55.9,15,11,6,5,18,67,40,4
ENG-Premier League,2425,West Ham,Aaron Cresswell,,,34.0,1989.0,9.2,11,7,5,5,1,9,11,81.8,2,9,4,5,8,19,37,0
ENG-Premier League,2425,West Ham,Aaron Wan-Bissaka,,,26.0,1997.0,35.0,70,49,33,32,5,23,32,71.9,9,37,11,26,66,136,125,0
ENG-Premier League,2425,West Ham,Alphonse Areola,,,31.0,1993.0,25.1,2,2,2,0,0,2,3,66.7,1,0,0,0,0,2,15,3
ENG-Premier League,2425,West Ham,Andy Irving,,,24.0,2000.0,1.8,7,4,3,3,1,1,5,20.0,4,5,1,4,1,8,5,0
ENG-Premier League,2425,West Ham,Carlos Soler,,,27.0,1997.0,15.7,16,11,9,6,1,7,23,30.4,16,19,6,13,8,24,21,2
ENG-Premier League,2425,West Ham,Crysencio Summerville,,,22.0,2001.0,8.7,13,7,2,8,3,3,9,33.3,6,13,4,9,0,13,7,0
ENG-Premier League,2425,West Ham,Danny Ings,,,32.0,1992.0,3.2,4,2,2,2,0,1,3,33.3,2,5,0,5,1,5,4,0
ENG-Premier League,2425,West Ham,Edson Álvarez,,,26.0,1997.0,19.7,50,27,27,15,8,17,35,48.6,18,23,8,15,18,68,46,1
ENG-Premier League,2425,West Ham,Emerson Palmieri,,,29.0,1994.0,23.5,60,31,37,18,5,27,48,56.3,21,32,8,24,21,81,59,0
ENG-Premier League,2425,West Ham,Evan Ferguson,,,19.0,2004.0,1.7,3,1,0,1,2,0,0,,0,2,1,1,1,4,1,0
ENG-Premier League,2425,West Ham,Guido Rodríguez,,,30.0,1994.0,12.8,36,19,21,15,0,17,33,51.5,16,23,9,14,13,49,35,1
ENG-Premier League,2425,West Ham,James Ward-Prowse,,,29.0,1994.0,11.5,20,14,8,8,4,7,19,36.8,12,6,3,3,8,28,15,0
ENG-Premier League,2425,West Ham,Jarrod Bowen,,,27.0,1996.0,33.0,41,26,13,12,16,19,40,47.5,21,22,4,18,16,57,25,0
ENG-Premier League,2425,West Ham,Jean-Clair Todibo,,,24.0,1999.0,20.3,47,28,30,15,2,26,36,72.2,10,25,13,12,26,73,83,3
ENG-Premier League,2425,West Ham,Kaelan Casey,,,19.0,2004.0,0.0,0,0,0,0,0,0,0,,0,0,0,0,0,0,1,0
ENG-Premier League,2425,West Ham,Konstantinos Mavropanos,,,26.0,1997.0,22.7,35,24,24,10,1,16,27,59.3,11,25,18,7,40,75,126,1
ENG-Premier League,2425,West Ham,Lewis Orford,,,18.0,2006.0,0.5,0,0,0,0,0,0,0,,0,1,0,1,1,1,0,0
ENG-Premier League,2425,West Ham,Lucas Paquetá,,,26.0,1997.0,26.4,66,37,25,30,11,27,55,49.1,28,29,4,25,18,84,37,6
ENG-Premier League,2425,West Ham,Luis Guilherme,,,18.0,2006.0,1.7,1,0,1,0,0,0,3,0.0,3,7,0,7,3,4,2,0
ENG-Premier League,2425,West Ham,Max Kilman,,,27.0,1997.0,37.2,39,24,16,20,3,23,27,85.2,4,58,40,18,38,77,212,6
ENG-Premier League,2425,West Ham,Michail Antonio,,,34.0,1990.0,9.3,2,2,0,1,1,2,3,66.7,1,6,0,6,0,2,2,0
ENG-Premier League,2425,West Ham,Mohammed Kudus,,,23.0,2000.0,28.8,38,23,9,18,11,10,27,37.0,17,24,1,23,4,42,8,2
ENG-Premier League,2425,West Ham,Niclas Füllkrug,,,31.0,1993.0,8.8,4,3,0,1,3,3,4,75.0,1,1,0,1,1,5,16,0
ENG-Premier League,2425,West Ham,Oliver Scarles,,,18.0,2005.0,7.4,21,11,17,3,1,14,22,63.6,8,14,2,12,11,32,26,0
ENG-Premier League,2425,West Ham,Tomáš Souček,,,29.0,1995.0,28.5,46,21,20,23,3,26,44,59.1,18,41,21,20,20,66,85,1
ENG-Premier League,2425,West Ham,Vladimír Coufal,,,31.0,1992.0,11.9,22,15,13,7,2,10,22,45.5,12,13,11,2,8,30,39,1
ENG-Premier League,2425,West Ham,Łukasz Fabiański,,,39.0,1985.0,12.9,0,0,0,0,0,0,1,0.0,1,0,0,0,0,0,5,1
ENG-Premier League,2425,Wolves,Alfie Pond,,,20.0,2004.0,0.0,0,0,0,0,0,0,0,,0,0,0,0,0,0,0,0
ENG-Premier League,2425,Wolves,André,,,23.0,2001.0,27.5,91,55,41,41,9,37,63,58.7,26,42,8,34,37,128,30,1
ENG-Premier League,2425,Wolves,Boubacar Traoré,,,22.0,2001.0,0.0,2,0,0,2,0,1,1,100.0,0,0,0,0,0,2,0,0
ENG-Premier League,2425,Wolves,Carlos Forbs,,,20.0,2004.0,2.7,8,5,5,2,1,4,6,66.7,2,3,0,3,1,9,2,1
ENG-Premier League,2425,Wolves,Chiquinho,,,24.0,2000.0,0.1,0,0,0,0,0,0,0,,0,0,0,0,0,0,0,0
ENG-Premier League,2425,Wolves,Craig Dawson,,,34.0,1990.0,10.8,15,3,8,6,1,12,15,80.0,3,16,11,5,9,24,52,1
ENG-Premier League,2425,Wolves,Daniel Bentley,,,31.0,1993.0,2.0,0,0,0,0,0,0,0,,0,0,0,0,0,0,1,0
ENG-Premier League,2425,Wolves,Daniel Podence,,,28.0,1995.0,0.5,0,0,0,0,0,0,1,0.0,1,0,0,0,0,0,0,0
ENG-Premier League,2425,Wolves,Emmanuel Agbadou,,,27.0,1997.0,15.7,30,19,21,9,0,13,20,65.0,7,19,13,6,12,42,90,0
ENG-Premier League,2425,Wolves,Gonçalo Guedes,,,27.0,1996.0,11.1,16,5,2,6,8,4,16,25.0,12,11,0,11,5,21,4,0
ENG-Premier League,2425,Wolves,Hwang Hee-chan,,,28.0,1996.0,7.3,6,4,2,1,3,2,6,33.3,4,9,0,9,2,8,11,0
ENG-Premier League,2425,Wolves,Jean-Ricner Bellegarde,,,26.0,1998.0,18.6,39,24,17,19,3,14,20,70.0,6,19,3,16,10,49,18,1
ENG-Premier League,2425,Wolves,José Sá,,,31.0,1993.0,29.0,2,2,2,0,0,2,2,100.0,0,0,0,0,0,2,15,1
ENG-Premier League,2425,Wolves,João Gomes,,,23.0,2001.0,33.0,116,71,55,53,8,48,110,43.6,62,42,4,38,25,141,33,0
ENG-Premier League,2425,Wolves,Jørgen Strand Larsen,,,24.0,2000.0,28.7,10,6,2,3,5,4,27,14.8,23,19,4,15,6,16,29,0
ENG-Premier League,2425,Wolves,Mario Lemina,,,30.0,1993.0,15.2,51,31,27,19,5,20,29,69.0,9,12,7,5,27,78,50,3
ENG-Premier League,2425,Wolves,Marshall Munetsi,,,28.0,1996.0,12.0,24,10,7,11,6,13,23,56.5,10,14,1,13,6,30,18,0
ENG-Premier League,2425,Wolves,Mateus Mane,,,,,0.0,0,0,0,0,0,0,0,,0,1,0,1,0,0,0,0
ENG-Premier League,2425,Wolves,Matheus Cunha,,,25.0,1999.0,28.9,38,22,17,16,5,13,39,33.3,26,21,1,20,17,55,23,0
ENG-Premier League,2425,Wolves,Matt Doherty,,,32.0,1992.0,23.4,38,21,25,13,0,17,25,68.0,8,28,15,13,22,60,102,3
ENG-Premier League,2425,Wolves,Nasser Djiga,,,21.0,2002.0,0.7,0,0,0,0,0,0,1,0.0,1,0,0,0,2,2,4,1
ENG-Premier League,2425,Wolves,Nélson Semedo,,,30.0,1993.0,32.1,62,36,32,21,9,34,57,59.6,23,32,10,22,23,85,104,3
ENG-Premier League,2425,Wolves,Pablo Sarabia,,,32.0,1992.0,9.0,16,8,4,8,4,10,16,62.5,6,10,0,10,4,20,7,1
ENG-Premier League,2425,Wolves,Pedro Lima,,,18.0,2006.0,0.8,1,0,0,0,1,1,3,33.3,2,0,0,0,2,3,5,0
ENG-Premier League,2425,Wolves,Rayan Aït-Nouri,,,23.0,2001.0,34.5,89,57,52,28,9,43,70,61.4,27,42,6,36,26,115,75,2
ENG-Premier League,2425,Wolves,Rodrigo Gomes,,,21.0,2003.0,9.0,23,15,14,9,0,12,21,57.1,9,8,1,7,7,30,20,1
ENG-Premier League,2425,Wolves,Sam Johnstone,,,31.0,1993.0,7.0,0,0,0,0,0,0,1,0.0,1,0,0,0,0,0,7,0
ENG-Premier League,2425,Wolves,Santiago Bueno,,,25.0,1998.0,18.7,41,21,22,18,1,17,22,77.3,5,36,21,15,15,56,70,0
ENG-Premier League,2425,Wolves,Tom King,,,29.0,1995.0,0.0,0,0,0,0,0,0,0,,0,0,0,0,0,0,0,0
ENG-Premier League,2425,Wolves,Tommy Doyle,,,22.0,2001.0,5.4,11,6,6,3,2,6,15,40.0,9,11,5,6,5,16,11,1
ENG-Premier League,2425,Wolves,Toti Gomes,,,25.0,1999.0,29.0,61,43,42,15,4,37,46,80.4,9,29,17,12,25,86,152,5
ENG-Premier League,2425,Wolves,Yerson Mosquera,,,23.0,2001.0,4.9,11,7,9,2,0,9,14,64.3,5,13,10,3,10,21,14,0
ESP-La Liga,2425,Alavés,Abdel Abqar,,,25.0,1999.0,27.4,36,23,24,11,1,20,34,58.8,14,28,18,10,39,75,146,1
ESP-La Liga,2425,Alavés,Abderrahman Rebbach,,,25.0,1998.0,4.3,3,2,3,0,0,0,6,0.0,6,4,0,4,0,3,6,0
ESP-La Liga,2425,Alavés,Adrian Rodriguez,,,23.0,2000.0,1.4,0,0,0,0,0,0,1,0.0,1,0,0,0,0,0,3,1
ESP-La Liga,2425,Alavés,Aleksandar Sedlar,,,32.0,1991.0,6.6,18,10,7,11,0,8,10,80.0,2,2,1,1,10,28,24,1
ESP-La Liga,2425,Alavés,Ander Guevara,,,27.0,1997.0,21.6,49,30,19,29,1,20,48,41.7,28,21,5,16,14,63,43,1
ESP-La Liga,2425,Alavés,Antonio Blanco,,,24.0,2000.0,30.3,67,40,23,37,7,32,83,38.6,51,30,7,23,42,109,48,1
ESP-La Liga,2425,Alavés,Antonio Sivera,,,27.0,1996.0,31.2,2,1,2,0,0,2,2,100.0,0,1,0,1,0,2,20,0
ESP-La Liga,2425,Alavés,Asier Villalibre,,,26.0,1997.0,3.7,2,2,0,1,1,1,2,50.0,1,1,0,1,1,3,7,0
ESP-La Liga,2425,Alavés,Carles Aleñá,,,26.0,1998.0,12.1,19,12,6,7,6,7,17,41.2,10,11,0,11,2,21,4,0
ESP-La Liga,2425,Alavés,Carlos Benavídez,,,26.0,1998.0,5.4,19,14,10,6,3,6,11,54.5,5,5,2,3,8,27,14,1
ESP-La Liga,2425,Alavés,Carlos Martín,,,22.0,2002.0,14.8,43,21,18,16,9,13,49,26.5,36,30,1,29,5,48,20,0
ESP-La Liga,2425,Alavés,Carlos Vicente,,,25.0,1999.0,34.4,47,31,26,11,10,25,64,39.1,39,34,2,32,14,61,40,0
ESP-La Liga,2425,Alavés,Facundo Garcés,,,24.0,1999.0,7.5,6,2,4,2,0,3,5,60.0,2,8,6,2,5,11,51,0
ESP-La Liga,2425,Alavés,Hugo Novoa,,,21.0,2003.0,2.6,8,5,4,3,1,5,5,100.0,0,2,1,1,0,8,6,0
ESP-La Liga,2425,Alavés,Jesús Owono,,,23.0,2001.0,5.4,1,1,1,0,0,1,1,100.0,0,0,0,0,0,1,2,0
ESP-La Liga,2425,Alavés,Joan Jordán,,,30.0,1994.0,15.7,32,18,11,17,4,17,30,56.7,13,12,0,12,9,41,21,0
ESP-La Liga,2425,Alavés,Jon Guridi,,,29.0,1995.0,23.1,40,22,7,26,7,18,44,40.9,26,19,1,18,14,54,16,0
ESP-La Liga,2425,Alavés,Kiké,,,34.0,1989.0,28.2,19,14,1,12,6,6,17,35.3,11,11,4,7,1,20,23,0
ESP-La Liga,2425,Alavés,Luis Rioja,,,30.0,1993.0,0.3,2,1,0,1,1,1,2,50.0,1,2,0,2,0,2,0,0
ESP-La Liga,2425,Alavés,Luka Romero,,,19.0,2004.0,2.2,4,4,1,1,2,2,3,66.7,1,2,0,2,1,5,0,0
ESP-La Liga,2425,Alavés,Manu Sánchez,,,23.0,2000.0,29.3,83,56,40,33,10,41,69,59.4,28,51,12,39,30,113,76,1
ESP-La Liga,2425,Alavés,Moussa Diarra,,,23.0,2000.0,20.7,40,24,19,18,3,17,29,58.6,12,15,5,10,21,61,46,1
ESP-La Liga,2425,Alavés,Nahuel Tenaglia,,,28.0,1996.0,32.5,96,61,61,30,5,53,88,60.2,35,33,9,24,47,143,123,2
ESP-La Liga,2425,Alavés,Pau Cabanes,,,19.0,2005.0,2.1,8,2,4,3,1,6,13,46.2,7,2,0,2,0,8,1,0
ESP-La Liga,2425,Alavés,Pica,,,22.0,2002.0,5.5,9,7,7,2,0,4,9,44.4,5,7,6,1,9,18,26,0
ESP-La Liga,2425,Alavés,Santiago Mouriño,,,22.0,2002.0,20.5,43,28,31,12,0,21,38,55.3,17,27,12,15,29,72,120,0
ESP-La Liga,2425,Alavés,Stoichkov,,,30.0,1993.0,7.8,14,9,6,7,1,6,11,54.5,5,2,0,2,1,15,7,0
ESP-La Liga,2425,Alavés,Tomás Conechny,,,26.0,1998.0,9.4,15,12,6,7,2,9,27,33.3,18,14,2,12,6,21,10,0
ESP-La Liga,2425,Alavés,Toni Martínez,,,27.0,1997.0,11.2,12,7,5,4,3,4,8,50.0,4,8,2,6,1,13,15,0
ESP-La Liga,2425,Athletic Club,Adama Boiro,,,22.0,2002.0,12.2,20,11,11,7,2,10,15,66.7,5,10,3,7,12,32,27,1
ESP-La Liga,2425,Athletic Club,Adu Ares,,,22.0,2001.0,0.2,0,0,0,0,0,0,1,0.0,1,0,0,0,0,0,0,0
ESP-La Liga,2425,Athletic Club,Aingeru Olabarrieta,,,18.0,2005.0,0.6,0,0,0,0,0,0,0,,0,2,0,2,1,1,1,0
ESP-La Liga,2425,Athletic Club,Aitor Paredes,,,24.0,2000.0,20.1,15,13,10,5,0,8,15,53.3,7,26,15,11,22,37,114,4
ESP-La Liga,2425,Athletic Club,Alex Padilla,,,20.0,2003.0,3.6,0,0,0,0,0,0,0,,0,0,0,0,0,0,2,1
ESP-La Liga,2425,Athletic Club,Ander Herrera,,,34.0,1989.0,3.0,8,4,1,7,0,3,6,50.0,3,1,0,1,2,10,10,0
ESP-La Liga,2425,Athletic Club,Andoni Gorosabel,,,27.0,1996.0,16.5,47,28,31,9,7,30,45,66.7,15,18,2,16,18,65,62,0
ESP-La Liga,2425,Athletic Club,Beñat Prados,,,23.0,2001.0,19.1,55,36,20,27,8,25,53,47.2,28,21,2,19,28,83,26,0
ESP-La Liga,2425,Athletic Club,Daniel Vivian,,,25.0,1999.0,29.0,40,26,23,14,3,21,32,65.6,11,26,10,16,47,87,152,2
ESP-La Liga,2425,Athletic Club,Endika Buján,,,21.0,2003.0,0.1,0,0,0,0,0,0,1,0.0,1,0,0,0,0,0,0,0
ESP-La Liga,2425,Athletic Club,Gorka Guruzeta,,,27.0,1996.0,20.4,16,8,1,13,2,7,31,22.6,24,28,4,24,9,25,23,0
ESP-La Liga,2425,Athletic Club,Iñaki Williams,,,30.0,1994.0,29.5,17,10,4,8,5,12,23,52.2,11,34,5,29,12,29,32,0
ESP-La Liga,2425,Athletic Club,Iñigo Lekue,,,31.0,1993.0,8.6,15,12,12,3,0,9,17,52.9,8,7,2,5,9,24,29,2
ESP-La Liga,2425,Athletic Club,Iñigo Ruiz de Galarreta,,,30.0,1993.0,16.4,36,22,11,17,8,20,31,64.5,11,11,4,7,16,52,14,2
ESP-La Liga,2425,Athletic Club,Javi Martón,,,25.0,1999.0,0.6,0,0,0,0,0,0,0,,0,0,0,0,0,0,0,0
ESP-La Liga,2425,Athletic Club,Julen Agirrezabala,,,23.0,2000.0,13.4,0,0,0,0,0,0,1,0.0,1,0,0,0,0,0,4,0
ESP-La Liga,2425,Athletic Club,Maroan Sannadi,,,23.0,2001.0,8.4,5,0,1,4,0,2,7,28.6,5,1,0,1,1,6,2,1
ESP-La Liga,2425,Athletic Club,Mikel Jauregizar,,,20.0,2003.0,24.9,84,48,25,45,14,41,83,49.4,42,24,4,20,29,113,36,2
ESP-La Liga,2425,Athletic Club,Mikel Vesga,,,31.0,1993.0,11.0,22,15,7,13,2,12,28,42.9,16,10,1,9,15,37,26,0
ESP-La Liga,2425,Athletic Club,Nico Williams,,,22.0,2002.0,22.2,28,18,10,11,7,11,32,34.4,21,20,1,19,7,35,9,0
ESP-La Liga,2425,Athletic Club,Nicolás Serrano,,,21.0,2003.0,1.2,1,1,0,1,0,1,3,33.3,2,4,0,4,1,2,1,0
ESP-La Liga,2425,Athletic Club,Oihan Sancet,,,24.0,2000.0,18.0,13,8,6,6,1,5,14,35.7,9,10,0,10,5,18,6,0
ESP-La Liga,2425,Athletic Club,Peio Canales,,,19.0,2005.0,2.9,3,2,0,1,2,1,1,100.0,0,3,0,3,2,5,2,0
ESP-La Liga,2425,Athletic Club,Unai Gómez,,,21.0,2003.0,14.3,12,8,3,7,2,4,7,57.1,3,13,1,12,2,14,15,1
ESP-La Liga,2425,Athletic Club,Unai Núñez,,,27.0,1997.0,7.2,10,5,7,3,0,4,7,57.1,3,4,4,0,17,27,46,1
ESP-La Liga,2425,Athletic Club,Unai Simón,,,27.0,1997.0,21.0,0,0,0,0,0,0,0,,0,1,0,1,1,1,14,4
ESP-La Liga,2425,Athletic Club,Yeray Álvarez,,,29.0,1995.0,19.8,25,13,14,9,2,15,22,68.2,7,10,6,4,34,59,129,1
ESP-La Liga,2425,Athletic Club,Yuri Berchiche,,,34.0,1990.0,22.7,33,21,19,11,3,19,33,57.6,14,25,5,20,27,60,72,3
ESP-La Liga,2425,Athletic Club,Álex Berenguer,,,29.0,1995.0,26.0,32,16,6,16,10,14,31,45.2,17,23,2,21,10,42,18,0
ESP-La Liga,2425,Athletic Club,Álvaro djaló,,,24.0,1999.0,7.3,8,5,3,2,3,1,3,33.3,2,4,0,4,1,9,4,0
ESP-La Liga,2425,Athletic Club,Óscar de Marcos,,,35.0,1989.0,17.4,32,15,15,13,4,21,37,56.8,16,17,1,16,16,48,35,0
ESP-La Liga,2425,Atlético Madrid,Adrian Niño,,,20.0,2004.0,0.1,0,0,0,0,0,0,0,,0,0,0,0,0,0,0,0
ESP-La Liga,2425,Atlético Madrid,Alexander Sørloth,,,28.0,1995.0,17.4,9,5,2,5,2,3,6,50.0,3,6,1,5,1,10,28,0
ESP-La Liga,2425,Atlético Madrid,Antoine Griezmann,,,33.0,1991.0,27.4,30,17,13,13,4,7,29,24.1,22,20,1,19,6,36,23,1
ESP-La Liga,2425,Atlético Madrid,Axel Witsel,,,35.0,1989.0,9.5,16,12,4,10,2,12,14,85.7,2,15,8,7,11,27,34,1
ESP-La Liga,2425,Atlético Madrid,Clément Lenglet,,,29.0,1995.0,21.9,27,17,19,8,0,11,15,73.3,4,24,18,6,22,49,104,1
ESP-La Liga,2425,Atlético Madrid,Conor Gallagher,,,24.0,2000.0,18.1,45,32,16,19,10,22,49,44.9,27,23,5,18,20,65,23,0
ESP-La Liga,2425,Atlético Madrid,César Azpilicueta,,,34.0,1989.0,9.7,25,14,12,9,4,17,23,73.9,6,10,2,8,5,30,32,0
ESP-La Liga,2425,Atlético Madrid,Giuliano Simeone,,,21.0,2002.0,21.4,27,13,6,11,10,15,30,50.0,15,22,3,19,14,41,22,1
ESP-La Liga,2425,Atlético Madrid,Jan Oblak,,,31.0,1993.0,36.0,0,0,0,0,0,0,0,,0,0,0,0,0,0,17,2
ESP-La Liga,2425,Atlético Madrid,Javi Galán,,,29.0,1994.0,19.8,51,31,31,15,5,25,49,51.0,24,13,3,10,12,63,47,0
ESP-La Liga,2425,Atlético Madrid,José María Giménez,,,29.0,1995.0,22.2,26,16,18,8,0,17,28,60.7,11,29,19,10,27,53,115,2
ESP-La Liga,2425,Atlético Madrid,Juan Musso,,,30.0,1994.0,2.0,0,0,0,0,0,0,0,,0,0,0,0,0,0,0,0
ESP-La Liga,2425,Atlético Madrid,Julián Álvarez,,,24.0,2000.0,27.9,25,17,5,11,9,8,30,26.7,22,14,0,14,2,27,12,1
ESP-La Liga,2425,Atlético Madrid,Koke,,,32.0,1992.0,21.4,46,23,18,22,6,21,43,48.8,22,24,2,22,20,66,29,2
ESP-La Liga,2425,Atlético Madrid,Marcos Llorente,,,29.0,1995.0,27.9,69,52,38,27,4,36,55,65.5,19,32,7,25,27,96,51,1
ESP-La Liga,2425,Atlético Madrid,Nahuel Molina,,,26.0,1998.0,17.7,44,19,21,21,2,31,56,55.4,25,16,3,13,13,57,53,0
ESP-La Liga,2425,Atlético Madrid,Pablo Barrios,,,21.0,2003.0,25.9,46,26,23,20,3,23,47,48.9,24,18,5,13,34,80,33,9
ESP-La Liga,2425,Atlético Madrid,Reinildo Mandava,,,30.0,1994.0,10.5,18,11,10,7,1,10,18,55.6,8,11,5,6,16,34,35,0
ESP-La Liga,2425,Atlético Madrid,Robin Le Normand,,,27.0,1996.0,23.9,27,18,23,4,0,12,20,60.0,8,20,9,11,10,37,120,1
ESP-La Liga,2425,Atlético Madrid,Rodrigo De Paul,,,30.0,1994.0,23.4,33,26,12,16,5,14,33,42.4,19,25,2,23,6,39,15,3
ESP-La Liga,2425,Atlético Madrid,Rodrigo Riquelme,,,24.0,2000.0,5.7,11,5,4,6,1,6,11,54.5,5,3,0,3,2,13,3,0
ESP-La Liga,2425,Atlético Madrid,Samuel Lino,,,24.0,1999.0,17.2,33,17,25,4,4,22,52,42.3,30,23,4,19,8,41,13,0
ESP-La Liga,2425,Atlético Madrid,Thomas Lemar,,,28.0,1995.0,0.9,2,1,1,1,0,2,4,50.0,2,0,0,0,0,2,1,0
ESP-La Liga,2425,Atlético Madrid,Ángel Correa,,,29.0,1995.0,8.9,9,3,4,1,4,5,15,33.3,10,10,0,10,4,13,8,0
ESP-La Liga,2425,Barcelona,Alejandro Balde,,,20.0,2003.0,25.4,18,10,10,5,3,11,17,64.7,6,24,5,19,5,23,27,0
ESP-La Liga,2425,Barcelona,Andreas Christensen,,,28.0,1996.0,2.8,6,4,4,1,1,4,4,100.0,0,2,0,2,4,10,9,0
ESP-La Liga,2425,Barcelona,Ansu Fati,,,21.0,2002.0,2.6,4,1,0,2,2,1,2,50.0,1,1,0,1,1,5,0,1
ESP-La Liga,2425,Barcelona,Dani Olmo,,,26.0,1998.0,13.5,16,11,8,5,3,4,14,28.6,10,6,3,3,3,19,11,1
ESP-La Liga,2425,Barcelona,Daniel Rodriguez,,,18.0,2005.0,0.4,0,0,0,0,0,0,0,,0,1,0,1,0,0,0,0
ESP-La Liga,2425,Barcelona,Eric García,,,23.0,2001.0,17.4,38,21,11,24,3,20,29,69.0,9,24,8,16,14,52,41,0
ESP-La Liga,2425,Barcelona,Fermin López,,,21.0,2003.0,13.9,19,15,3,9,7,8,32,25.0,24,11,0,11,5,24,3,0
ESP-La Liga,2425,Barcelona,Ferrán Torres,,,24.0,2000.0,12.3,8,4,2,3,3,3,8,37.5,5,7,1,6,4,12,5,0
ESP-La Liga,2425,Barcelona,Frenkie de Jong,,,27.0,1997.0,12.7,19,11,5,8,6,8,16,50.0,8,9,1,8,12,31,7,1
ESP-La Liga,2425,Barcelona,Gavi,,,19.0,2004.0,12.1,30,21,10,15,5,15,26,57.7,11,14,1,13,10,40,7,0
ESP-La Liga,2425,Barcelona,Gerard Martín,,,22.0,2002.0,11.5,22,10,10,7,5,11,16,68.8,5,16,2,14,13,35,27,0
ESP-La Liga,2425,Barcelona,Héctor Fort,,,17.0,2006.0,6.5,13,8,6,4,3,10,16,62.5,6,12,0,12,6,19,16,0
ESP-La Liga,2425,Barcelona,Iñaki Peña,,,25.0,1999.0,15.5,0,0,0,0,0,0,2,0.0,2,0,0,0,0,0,20,1
ESP-La Liga,2425,Barcelona,Iñigo Martínez,,,33.0,1991.0,27.7,25,14,20,5,0,16,22,72.7,6,18,7,11,18,43,108,1
ESP-La Liga,2425,Barcelona,Jules Koundé,,,25.0,1998.0,28.9,63,43,29,23,11,44,66,66.7,22,35,5,30,20,83,68,2
ESP-La Liga,2425,Barcelona,Lamine Yamal,,,17.0,2007.0,31.7,42,28,8,17,17,16,38,42.1,22,12,0,12,16,58,3,0
ESP-La Liga,2425,Barcelona,Marc Bernal,,,17.0,2007.0,2.7,8,6,2,5,1,7,8,87.5,1,5,1,4,1,9,4,0
ESP-La Liga,2425,Barcelona,Marc Casado,,,20.0,2003.0,17.9,44,25,7,30,7,20,41,48.8,21,20,5,15,22,66,22,1
ESP-La Liga,2425,Barcelona,Marc-André ter Stegen,,,32.0,1992.0,7.5,0,0,0,0,0,0,1,0.0,1,0,0,0,0,0,2,2
ESP-La Liga,2425,Barcelona,Pablo Torre,,,21.0,2003.0,3.4,5,4,1,3,1,2,4,50.0,2,0,0,0,3,8,5,1
ESP-La Liga,2425,Barcelona,Pau Cubarsí,,,17.0,2007.0,29.1,34,23,21,10,3,19,30,63.3,11,12,9,3,16,50,86,1
ESP-La Liga,2425,Barcelona,Pau Victor,,,22.0,2001.0,3.5,3,1,0,2,1,0,3,0.0,3,6,1,5,2,5,5,0
ESP-La Liga,2425,Barcelona,Pedri,,,21.0,2002.0,32.0,61,34,14,38,9,24,70,34.3,46,45,3,42,26,87,21,1
ESP-La Liga,2425,Barcelona,Raphinha,,,27.0,1996.0,31.5,36,22,6,19,11,19,39,48.7,20,29,2,27,11,47,26,0
ESP-La Liga,2425,Barcelona,Robert Lewandowski,,,35.0,1988.0,29.6,10,5,1,5,4,5,11,45.5,6,14,2,12,3,13,26,0
ESP-La Liga,2425,Barcelona,Ronald Araújo,,,25.0,1999.0,8.4,12,9,6,5,1,4,5,80.0,1,6,4,2,9,21,25,0
ESP-La Liga,2425,Barcelona,Sergi Dominguez,,,19.0,2005.0,1.9,1,1,1,0,0,0,0,,0,0,0,0,3,4,7,0
ESP-La Liga,2425,Barcelona,Wojciech Szczęsny,,,34.0,1990.0,15.0,1,1,1,0,0,0,0,,0,0,0,0,0,1,20,1
ESP-La Liga,2425,Betis,Abde Ezzalzouli,,,22.0,2001.0,22.0,37,25,17,16,4,15,27,55.6,12,22,3,19,7,44,19,0
ESP-La Liga,2425,Betis,Adrián,,,37.0,1987.0,19.0,0,0,0,0,0,0,3,0.0,3,0,0,0,0,0,14,3
ESP-La Liga,2425,Betis,Aitor Ruibal,,,28.0,1996.0,14.6,32,23,22,4,6,25,47,53.2,22,20,5,15,14,46,40,1
ESP-La Liga,2425,Betis,Antony,,,24.0,2000.0,15.1,25,11,6,9,10,8,22,36.4,14,12,1,11,10,35,9,1
ESP-La Liga,2425,Betis,Assane Diao,,,18.0,2005.0,3.1,5,3,1,3,1,4,9,44.4,5,3,0,3,0,5,3,0
ESP-La Liga,2425,Betis,Carlos Guirao,,,21.0,2003.0,1.2,5,3,1,4,0,4,6,66.7,2,1,1,0,3,8,2,0
ESP-La Liga,2425,Betis,Cucho,,,25.0,1999.0,12.7,15,10,2,5,8,6,11,54.5,5,13,1,12,7,22,4,0
ESP-La Liga,2425,Betis,Cédric Bakambu,,,33.0,1991.0,7.9,6,4,0,5,1,3,7,42.9,4,13,2,11,0,6,5,0
ESP-La Liga,2425,Betis,Diego Llorente,,,30.0,1993.0,28.0,36,20,23,12,1,25,38,65.8,13,29,20,9,43,79,154,1
ESP-La Liga,2425,Betis,Ezequiel Ávila,,,30.0,1994.0,7.5,8,3,2,2,4,4,10,40.0,6,4,0,4,2,10,8,0
ESP-La Liga,2425,Betis,Fran Vieites,,,25.0,1999.0,4.0,0,0,0,0,0,0,0,,0,0,0,0,0,0,1,0
ESP-La Liga,2425,Betis,Giovani Lo Celso,,,28.0,1996.0,16.2,34,22,8,17,9,17,25,68.0,8,14,2,12,5,39,3,1
ESP-La Liga,2425,Betis,Héctor Bellerín,,,29.0,1995.0,6.4,13,7,7,4,2,10,17,58.8,7,5,3,2,6,19,21,0
ESP-La Liga,2425,Betis,Iker Losada,,,22.0,2001.0,3.7,10,7,2,4,4,5,10,50.0,5,2,0,2,3,13,2,0
ESP-La Liga,2425,Betis,Isco,,,32.0,1992.0,17.2,20,13,3,13,4,7,28,25.0,21,10,0,10,11,31,7,0
ESP-La Liga,2425,Betis,Jesus Rodríguez,,,18.0,2005.0,12.3,16,14,6,6,4,5,18,27.8,13,16,0,16,6,22,3,0
ESP-La Liga,2425,Betis,Johnny Cardoso,,,22.0,2001.0,23.8,55,31,12,35,8,20,52,38.5,32,27,12,15,48,103,64,1
ESP-La Liga,2425,Betis,Juanmi,,,31.0,1993.0,2.7,7,4,3,3,1,4,6,66.7,2,4,0,4,1,8,4,0
ESP-La Liga,2425,Betis,Marc Bartra,,,33.0,1991.0,23.3,33,19,20,13,0,15,26,57.7,11,41,25,16,33,66,148,0
ESP-La Liga,2425,Betis,Marc Roca,,,27.0,1996.0,10.1,20,14,10,9,1,9,17,52.9,8,17,5,12,14,34,14,2
ESP-La Liga,2425,Betis,Mateo Flores,,,20.0,2004.0,1.7,3,1,3,0,0,1,1,100.0,0,1,0,1,2,5,3,0
ESP-La Liga,2425,Betis,Nabil Fekir,,,31.0,1993.0,2.0,3,2,1,1,1,1,2,50.0,1,2,0,2,0,3,0,0
ESP-La Liga,2425,Betis,Natan,,,23.0,2001.0,24.2,35,24,24,9,2,26,30,86.7,4,24,14,10,28,63,123,2
ESP-La Liga,2425,Betis,Nobel Mendy,,,19.0,2004.0,1.2,0,0,0,0,0,0,0,,0,2,0,2,4,4,10,1
ESP-La Liga,2425,Betis,Pablo Fornals,,,28.0,1996.0,20.3,21,13,12,6,3,10,30,33.3,20,24,4,20,23,44,15,1
ESP-La Liga,2425,Betis,Pablo Garcia,,,17.0,2006.0,0.4,0,0,0,0,0,0,0,,0,1,0,1,0,0,0,0
ESP-La Liga,2425,Betis,Ricardo Rodríguez,,,31.0,1992.0,14.2,28,15,16,5,7,17,26,65.4,9,10,1,9,8,36,51,0
ESP-La Liga,2425,Betis,Rodri,,,24.0,2000.0,1.3,2,1,1,1,0,1,2,50.0,1,2,1,1,1,3,1,1
ESP-La Liga,2425,Betis,Romain Perraud,,,26.0,1997.0,22.2,36,22,15,16,5,21,46,45.7,25,18,4,14,22,58,71,1
ESP-La Liga,2425,Betis,Rui Silva,,,30.0,1994.0,15.0,0,0,0,0,0,0,1,0.0,1,1,0,1,0,0,7,0
ESP-La Liga,2425,Betis,Sergi Altimira,,,22.0,2001.0,21.9,61,37,17,38,6,36,60,60.0,24,28,1,27,24,85,43,3
ESP-La Liga,2425,Betis,Sergio Arribas,,,21.0,2003.0,1.0,7,4,4,3,0,6,7,85.7,1,2,2,0,3,10,4,0
ESP-La Liga,2425,Betis,Vitor Roque,,,19.0,2005.0,13.7,11,6,1,6,4,1,5,20.0,4,5,0,5,7,18,4,0
ESP-La Liga,2425,Betis,William Carvalho,,,32.0,1992.0,5.4,9,6,3,6,0,4,6,66.7,2,6,2,4,3,12,6,0
ESP-La Liga,2425,Betis,Youssouf Sabaly,,,31.0,1993.0,17.6,40,25,21,15,4,24,32,75.0,8,21,4,17,13,53,40,0
ESP-La Liga,2425,Betis,Ángel Ortíz,,,20.0,2004.0,3.9,12,8,8,3,1,8,17,47.1,9,6,0,6,5,17,7,0
ESP-La Liga,2425,Celta Vigo,Alfon,,,25.0,1999.0,15.2,8,3,3,2,3,4,12,33.3,8,8,0,8,5,13,5,1
ESP-La Liga,2425,Celta Vigo,Anastasios Douvikas,,,24.0,1999.0,7.8,9,4,2,6,1,3,6,50.0,3,5,2,3,3,12,6,0
ESP-La Liga,2425,Celta Vigo,Borja Iglesias,,,31.0,1993.0,21.7,10,9,2,5,3,4,15,26.7,11,9,2,7,7,17,10,0
ESP-La Liga,2425,Celta Vigo,Carl Starfelt,,,29.0,1995.0,25.2,40,20,25,14,1,18,27,66.7,9,29,21,8,31,71,129,3
ESP-La Liga,2425,Celta Vigo,Carlos Dominguez,,,23.0,2001.0,13.1,23,11,14,9,0,15,21,71.4,6,16,11,5,13,36,80,1
ESP-La Liga,2425,Celta Vigo,Damián Rodríguez,,,21.0,2003.0,10.3,14,9,3,10,1,6,16,37.5,10,6,1,5,7,21,13,0
ESP-La Liga,2425,Celta Vigo,Fer López,,,,,7.5,9,5,1,6,2,2,13,15.4,11,10,0,10,2,11,7,0
ESP-La Liga,2425,Celta Vigo,Fran Beltrán,,,25.0,1999.0,26.9,50,35,24,21,5,24,56,42.9,32,26,6,20,26,76,34,4
ESP-La Liga,2425,Celta Vigo,Franco Cervi,,,30.0,1994.0,3.0,8,3,2,6,0,3,8,37.5,5,4,0,4,8,16,7,0
ESP-La Liga,2425,Celta Vigo,Hugo Sotelo,,,20.0,2003.0,13.9,28,17,8,10,10,13,31,41.9,18,9,1,8,5,33,9,1
ESP-La Liga,2425,Celta Vigo,Hugo Álvarez,,,21.0,2003.0,17.5,26,9,12,10,4,10,19,52.6,9,19,2,17,8,34,29,1
ESP-La Liga,2425,Celta Vigo,Iago Aspas,,,36.0,1987.0,19.4,13,8,4,5,4,8,20,40.0,12,18,1,17,8,21,5,0
ESP-La Liga,2425,Celta Vigo,Iker Losada,,,22.0,2001.0,4.0,3,3,0,1,2,1,5,20.0,4,4,1,3,1,4,8,0
ESP-La Liga,2425,Celta Vigo,Ilaix Moriba,,,21.0,2003.0,23.7,68,42,24,30,14,32,57,56.1,25,29,4,25,14,82,33,1
ESP-La Liga,2425,Celta Vigo,Iván Villar,,,27.0,1997.0,4.0,0,0,0,0,0,0,0,,0,0,0,0,0,0,3,0
ESP-La Liga,2425,Celta Vigo,Jailson Siqueira,,,28.0,1995.0,6.8,13,11,9,3,1,9,11,81.8,2,6,4,2,9,22,28,1
ESP-La Liga,2425,Celta Vigo,Javi Rodríguez,,,21.0,2003.0,27.9,53,38,35,17,1,33,47,70.2,14,29,10,19,33,86,96,2
ESP-La Liga,2425,Celta Vigo,Javier Manquillo,,,30.0,1994.0,5.7,7,5,4,3,0,2,10,20.0,8,5,3,2,7,14,14,0
ESP-La Liga,2425,Celta Vigo,Jonathan Bamba,,,28.0,1996.0,9.0,12,7,4,6,2,5,12,41.7,7,6,0,6,5,17,6,0
ESP-La Liga,2425,Celta Vigo,Joseph Aidoo,,,28.0,1995.0,0.0,1,0,1,0,0,0,0,,0,0,0,0,0,1,0,0
ESP-La Liga,2425,Celta Vigo,Luca de la Torre,,,26.0,1998.0,0.0,0,0,0,0,0,0,0,,0,0,0,0,0,0,0,0
ESP-La Liga,2425,Celta Vigo,Marcos Alonso,,,33.0,1990.0,29.4,35,21,19,13,3,25,44,56.8,19,22,7,15,34,69,126,4
ESP-La Liga,2425,Celta Vigo,Mihailo Ristić,,,28.0,1995.0,4.8,7,7,4,2,1,4,6,66.7,2,1,0,1,2,9,18,0
ESP-La Liga,2425,Celta Vigo,Pablo Durán,,,23.0,2001.0,15.5,17,9,4,7,6,5,16,31.3,11,12,3,9,8,25,18,0
ESP-La Liga,2425,Celta Vigo,Sergio Carreira,,,23.0,2000.0,18.4,28,16,16,6,6,14,26,53.8,12,20,2,18,17,45,37,0
ESP-La Liga,2425,Celta Vigo,Tadeo Allende,,,25.0,1999.0,0.0,0,0,0,0,0,0,0,,0,0,0,0,0,0,0,0
ESP-La Liga,2425,Celta Vigo,Vicente Guaita,,,37.0,1987.0,34.0,0,0,0,0,0,0,0,,0,0,0,0,0,0,21,3
ESP-La Liga,2425,Celta Vigo,Williot Swedberg,,,20.0,2004.0,15.0,23,16,9,10,4,13,20,65.0,7,12,1,11,3,26,10,1
ESP-La Liga,2425,Celta Vigo,Yoel Lago,,,20.0,2004.0,6.5,12,8,8,3,1,7,9,77.8,2,5,4,1,4,16,30,0
ESP-La Liga,2425,Celta Vigo,Óscar Mingueza,,,25.0,1999.0,30.3,38,24,21,12,5,26,69,37.7,43,35,5,30,22,60,46,7
ESP-La Liga,2425,Espanyol,Alejo Véliz,,,20.0,2003.0,12.5,1,1,0,1,0,1,7,14.3,6,12,2,10,4,5,23,1
ESP-La Liga,2425,Espanyol,Alex Král,,,26.0,1998.0,30.2,55,37,28,24,3,16,30,53.3,14,34,14,20,28,83,51,2
ESP-La Liga,2425,Espanyol,Antoniu,,,21.0,2002.0,11.4,21,10,9,8,4,9,21,42.9,12,14,2,12,8,29,11,1
ESP-La Liga,2425,Espanyol,Brian Oliván,,,30.0,1994.0,11.3,13,10,7,6,0,4,13,30.8,9,6,2,4,10,23,23,0
ESP-La Liga,2425,Espanyol,Carlos Romero,,,22.0,2001.0,28.4,73,47,49,16,8,45,82,54.9,37,50,15,35,30,103,102,1
ESP-La Liga,2425,Espanyol,Edu Expósito,,,27.0,1996.0,11.6,23,13,9,13,1,9,23,39.1,14,3,0,3,15,38,21,2
ESP-La Liga,2425,Espanyol,Fernando Calero,,,28.0,1995.0,7.9,18,10,13,4,1,8,12,66.7,4,16,9,7,16,34,50,1
ESP-La Liga,2425,Espanyol,Irvin Cardona,,,26.0,1997.0,6.7,8,5,2,4,2,6,16,37.5,10,5,1,4,4,12,10,0
ESP-La Liga,2425,Espanyol,Javi Puado,,,26.0,1998.0,33.0,22,17,14,4,4,8,20,40.0,12,18,3,15,5,27,19,0
ESP-La Liga,2425,Espanyol,Joan García,,,23.0,2001.0,38.0,0,0,0,0,0,0,1,0.0,1,1,0,1,0,0,18,4
ESP-La Liga,2425,Espanyol,Jofre,,,23.0,2001.0,24.1,22,16,14,5,3,13,23,56.5,10,13,0,13,15,37,29,0
ESP-La Liga,2425,Espanyol,José Gragera,,,23.0,2000.0,6.3,25,16,11,14,0,9,17,52.9,8,9,1,8,5,30,13,0
ESP-La Liga,2425,Espanyol,Justin Smith,,,21.0,2003.0,2.3,9,3,3,6,0,4,6,66.7,2,5,1,4,4,13,3,0
ESP-La Liga,2425,Espanyol,Leandro Cabrera,,,33.0,1991.0,31.9,40,23,29,8,3,19,33,57.6,14,35,25,10,30,70,199,2
ESP-La Liga,2425,Espanyol,Marash Kumbulla,,,24.0,2000.0,33.0,51,26,35,14,2,24,41,58.5,17,48,35,13,34,85,224,2
ESP-La Liga,2425,Espanyol,Naci Ünüvar,,,21.0,2003.0,0.3,2,2,1,1,0,1,2,50.0,1,0,0,0,0,2,0,0
ESP-La Liga,2425,Espanyol,Omar El Hilali,,,20.0,2003.0,35.0,111,79,81,24,6,64,95,67.4,31,53,13,40,46,157,145,2
ESP-La Liga,2425,Espanyol,Pere Milla,,,31.0,1992.0,5.1,6,2,5,0,1,1,18,5.6,17,10,2,8,3,9,5,0
ESP-La Liga,2425,Espanyol,Pol Lozano,,,24.0,1999.0,21.6,53,34,23,25,5,25,58,43.1,33,32,6,26,22,75,31,0
ESP-La Liga,2425,Espanyol,Rafael Bauza,,,19.0,2005.0,2.0,5,3,3,1,1,4,7,57.1,3,3,1,2,0,5,5,0
ESP-La Liga,2425,Espanyol,Roberto Férnandez,,,22.0,2002.0,16.6,4,4,2,1,1,0,5,0.0,5,9,1,8,3,7,26,0
ESP-La Liga,2425,Espanyol,Roger Hinojo,,,19.0,2005.0,0.1,0,0,0,0,0,0,0,,0,0,0,0,0,0,1,0
ESP-La Liga,2425,Espanyol,Sergi Gómez,,,32.0,1992.0,7.4,8,5,7,1,0,2,3,66.7,1,12,8,4,7,15,38,0
ESP-La Liga,2425,Espanyol,Urko González,,,23.0,2001.0,15.3,46,28,24,21,1,28,44,63.6,16,27,12,15,8,54,39,1
ESP-La Liga,2425,Espanyol,Walid Cheddira,,,26.0,1998.0,7.1,5,0,1,1,3,0,1,0.0,1,4,0,4,1,6,6,0
ESP-La Liga,2425,Espanyol,Álvaro Aguado,,,28.0,1996.0,4.9,5,2,3,2,0,3,9,33.3,6,7,1,6,4,9,5,1
ESP-La Liga,2425,Espanyol,Álvaro Tejero,,,28.0,1996.0,13.8,14,4,7,6,1,7,23,30.4,16,9,1,8,13,27,34,1
ESP-La Liga,2425,Getafe,Abdoulaye Keita,,,21.0,2002.0,1.1,2,2,0,1,1,2,4,50.0,2,1,0,1,0,2,3,0
ESP-La Liga,2425,Getafe,Alberto Risco,,,18.0,2005.0,0.8,4,4,2,0,2,1,6,16.7,5,2,0,2,0,4,0,0
ESP-La Liga,2425,Getafe,Alex Sola,,,25.0,1999.0,11.4,21,14,9,12,0,9,25,36.0,16,8,0,8,7,28,11,1
ESP-La Liga,2425,Getafe,Allan Nyom,,,36.0,1988.0,9.9,18,11,7,9,2,15,17,88.2,2,4,2,2,4,22,23,0
ESP-La Liga,2425,Getafe,Bertuğ Yıldırım,,,22.0,2002.0,12.0,10,5,0,7,3,2,7,28.6,5,13,2,11,1,11,16,0
ESP-La Liga,2425,Getafe,Borja Mayoral,,,27.0,1997.0,12.4,5,4,2,2,1,3,9,33.3,6,4,0,4,2,7,6,0
ESP-La Liga,2425,Getafe,Carles Aleñá,,,26.0,1998.0,5.0,6,3,2,3,1,4,13,30.8,9,9,1,8,0,6,7,0
ESP-La Liga,2425,Getafe,Carles Pérez,,,26.0,1998.0,15.9,33,23,11,14,8,21,48,43.8,27,19,2,17,6,39,22,0
ESP-La Liga,2425,Getafe,Christantus Uche,,,21.0,2003.0,27.6,35,21,8,19,8,9,20,45.0,11,20,2,18,10,45,19,0
ESP-La Liga,2425,Getafe,Coba da Costa,,,22.0,2002.0,11.2,29,13,9,16,4,13,26,50.0,13,24,0,24,8,37,10,0
ESP-La Liga,2425,Getafe,David Argüelles,,,22.0,2002.0,0.1,0,0,0,0,0,0,0,,0,2,0,2,0,0,0,0
ESP-La Liga,2425,Getafe,David Soria,,,31.0,1993.0,38.0,4,4,4,0,0,4,5,80.0,1,0,0,0,1,5,21,3
ESP-La Liga,2425,Getafe,Diego Rico,,,31.0,1993.0,31.3,81,49,47,29,5,47,85,55.3,38,41,3,38,34,115,102,2
ESP-La Liga,2425,Getafe,Djené,,,32.0,1991.0,28.3,25,13,12,11,2,12,32,37.5,20,18,8,10,21,46,107,3
ESP-La Liga,2425,Getafe,Domingos Duarte,,,29.0,1995.0,20.7,28,15,22,4,2,17,21,81.0,4,28,16,12,18,46,152,1
ESP-La Liga,2425,Getafe,Gorka Rivera Alonso,,,19.0,2004.0,0.2,2,0,0,2,0,2,2,100.0,0,0,0,0,0,2,0,0
ESP-La Liga,2425,Getafe,Iglesias,,,26.0,1998.0,32.1,81,47,42,33,6,46,90,51.1,44,47,8,39,50,131,133,1
ESP-La Liga,2425,Getafe,Ismael Bekhoucha,,,19.0,2004.0,0.8,1,1,1,0,0,1,2,50.0,1,2,1,1,2,3,2,0
ESP-La Liga,2425,Getafe,Jesús Santiago,,,20.0,2004.0,4.1,14,8,6,8,0,5,10,50.0,5,6,2,4,1,15,3,0
ESP-La Liga,2425,Getafe,John Joe,,,20.0,2003.0,0.5,0,0,0,0,0,0,0,,0,1,1,0,0,0,1,0
ESP-La Liga,2425,Getafe,Juan Bernat,,,31.0,1993.0,7.8,19,13,9,5,5,7,12,58.3,5,9,3,6,2,21,12,0
ESP-La Liga,2425,Getafe,Juan Berrocal,,,25.0,1999.0,11.8,14,7,10,4,0,10,14,71.4,4,6,3,3,15,29,59,0
ESP-La Liga,2425,Getafe,Juanmi,,,31.0,1993.0,7.7,14,11,4,7,3,6,19,31.6,13,6,0,6,2,16,3,0
ESP-La Liga,2425,Getafe,Luis Milla,,,29.0,1994.0,31.9,61,40,28,25,8,35,72,48.6,37,25,0,25,24,85,28,3
ESP-La Liga,2425,Getafe,Mauro Arambarri,,,28.0,1995.0,29.6,48,29,10,33,5,22,48,45.8,26,35,6,29,15,63,46,0
ESP-La Liga,2425,Getafe,Nabil Aberdin,,,21.0,2002.0,2.9,6,4,3,3,0,1,1,100.0,0,3,0,3,0,6,5,0
ESP-La Liga,2425,Getafe,Omar Alderete,,,27.0,1996.0,33.0,43,29,30,11,2,20,30,66.7,10,38,22,16,40,83,241,1
ESP-La Liga,2425,Getafe,Peter González,,,22.0,2002.0,5.3,11,6,2,5,4,6,9,66.7,3,8,0,8,2,13,5,0
ESP-La Liga,2425,Getafe,Ramón Terrats,,,23.0,2000.0,13.5,20,10,7,8,5,8,28,28.6,20,9,2,7,8,28,16,0
ESP-La Liga,2425,Getafe,Álvaro Rodríguez,,,20.0,2004.0,9.5,10,7,0,7,3,5,10,50.0,5,23,0,23,3,13,12,0
ESP-La Liga,2425,Girona,Abel Ruiz,,,24.0,2000.0,15.0,6,2,2,2,2,2,5,40.0,3,7,2,5,5,11,7,0
ESP-La Liga,2425,Girona,Alejandro Francés,,,21.0,2002.0,13.0,36,24,22,13,1,28,40,70.0,12,17,8,9,17,53,52,0
ESP-La Liga,2425,Girona,Arnau Martinez,,,21.0,2003.0,29.2,51,28,30,15,6,32,63,50.8,31,18,6,12,31,82,76,2
ESP-La Liga,2425,Girona,Arnaut Danjuma,,,27.0,1997.0,14.8,8,6,3,3,2,2,7,28.6,5,5,1,4,2,10,4,0
ESP-La Liga,2425,Girona,Arthur Melo,,,27.0,1996.0,10.5,25,11,8,12,5,14,27,51.9,13,5,1,4,8,33,12,1
ESP-La Liga,2425,Girona,Bojan Miovski,,,25.0,1999.0,9.7,7,5,2,2,3,2,7,28.6,5,4,0,4,2,9,7,0
ESP-La Liga,2425,Girona,Bryan Gil,,,23.0,2001.0,19.1,34,20,10,15,9,14,30,46.7,16,24,0,24,10,44,9,4
ESP-La Liga,2425,Girona,Cristhian Stuani,,,37.0,1986.0,12.0,9,7,1,7,1,5,8,62.5,3,4,1,3,7,16,11,0
ESP-La Liga,2425,Girona,Daley Blind,,,34.0,1990.0,30.9,49,27,26,19,4,31,48,64.6,17,32,9,23,32,81,94,2
ESP-La Liga,2425,Girona,David López,,,34.0,1989.0,27.0,32,24,22,7,3,18,31,58.1,13,22,12,10,14,46,111,2
ESP-La Liga,2425,Girona,Donny van de Beek,,,27.0,1997.0,15.8,29,18,17,7,5,13,26,50.0,13,19,3,16,10,39,12,0
ESP-La Liga,2425,Girona,Ferrán Ruiz,,,21.0,2003.0,0.2,0,0,0,0,0,0,0,,0,2,1,1,1,1,0,0
ESP-La Liga,2425,Girona,Gabriel Osei Misehouy,,,19.0,2005.0,2.9,1,1,0,1,0,0,1,0.0,1,0,0,0,0,1,0,0
ESP-La Liga,2425,Girona,Iker Almena,,,20.0,2004.0,0.5,0,0,0,0,0,0,1,0.0,1,1,0,1,0,0,2,0
ESP-La Liga,2425,Girona,Iván Martín,,,25.0,1999.0,22.7,32,19,14,14,4,15,34,44.1,19,20,6,14,11,43,15,1
ESP-La Liga,2425,Girona,Jhon Solis,,,19.0,2004.0,5.9,13,7,3,9,1,6,14,42.9,8,13,1,12,4,17,6,1
ESP-La Liga,2425,Girona,Juanpe,,,33.0,1991.0,8.1,8,5,5,3,0,6,8,75.0,2,15,10,5,8,16,56,1
ESP-La Liga,2425,Girona,Kim Minsu,,,18.0,2006.0,0.2,1,0,0,1,0,0,0,,0,0,0,0,0,1,0,0
ESP-La Liga,2425,Girona,Krapyvtsov Vladyslav,,,19.0,2005.0,2.0,0,0,0,0,0,0,0,,0,0,0,0,0,0,1,1
ESP-La Liga,2425,Girona,Ladislav Krejčí,,,25.0,1999.0,27.1,23,16,19,4,0,14,26,53.8,12,24,19,5,34,57,93,5
ESP-La Liga,2425,Girona,Miguel Gutiérrez,,,23.0,2001.0,27.3,37,24,18,16,3,17,37,45.9,20,17,7,10,16,53,34,3
ESP-La Liga,2425,Girona,Oriol Romeu,,,32.0,1991.0,15.1,38,25,14,19,5,14,26,53.8,12,22,8,14,12,50,20,4
ESP-La Liga,2425,Girona,Papa Ba,,,19.0,2004.0,0.5,1,1,1,0,0,0,0,,0,1,0,1,0,1,1,0
ESP-La Liga,2425,Girona,Pau López,,,29.0,1994.0,0.5,0,0,0,0,0,0,0,,0,0,0,0,0,0,1,0
ESP-La Liga,2425,Girona,Paulo Gazzaniga,,,32.0,1992.0,35.5,1,1,1,0,0,1,1,100.0,0,1,0,1,0,1,17,3
ESP-La Liga,2425,Girona,Portu,,,32.0,1992.0,8.7,13,7,5,5,3,7,10,70.0,3,8,0,8,0,13,2,0
ESP-La Liga,2425,Girona,Silvi Clúa,,,19.0,2005.0,1.8,8,7,4,3,1,4,6,66.7,2,1,0,1,2,10,6,0
ESP-La Liga,2425,Girona,Viktor Tsyhankov,,,26.0,1997.0,21.3,19,12,4,7,8,9,19,47.4,10,7,1,6,15,34,16,1
ESP-La Liga,2425,Girona,Yangel Herrera,,,26.0,1998.0,25.1,66,39,31,27,8,30,59,50.8,29,24,8,16,31,97,50,2
ESP-La Liga,2425,Girona,Yaser Asprilla,,,20.0,2003.0,15.6,22,12,6,8,8,8,23,34.8,15,14,0,14,7,29,7,1
ESP-La Liga,2425,Las Palmas,Aboubacar Bassinga,,,19.0,2005.0,0.0,0,0,0,0,0,0,0,,0,0,0,0,0,0,0,0
ESP-La Liga,2425,Las Palmas,Adnan Januzaj,,,29.0,1995.0,6.6,10,6,1,6,3,5,9,55.6,4,6,0,6,2,12,3,0
ESP-La Liga,2425,Las Palmas,Alberto Moleiro,,,20.0,2003.0,30.2,27,12,12,14,1,18,48,37.5,30,24,0,24,18,45,8,0
ESP-La Liga,2425,Las Palmas,Andy Pelmard,,,24.0,2000.0,2.3,5,0,3,2,0,4,5,80.0,1,3,1,2,2,7,20,0
ESP-La Liga,2425,Las Palmas,Arturo Rodríguez,,,17.0,2006.0,0.2,0,0,0,0,0,0,0,,0,0,0,0,0,0,0,0
ESP-La Liga,2425,Las Palmas,Benito Ramírez,,,29.0,1995.0,5.3,10,5,4,6,0,9,16,56.3,7,8,3,5,1,11,14,1
ESP-La Liga,2425,Las Palmas,Daley Sinkgraven,,,29.0,1995.0,1.0,5,1,3,2,0,1,3,33.3,2,1,0,1,1,6,2,0
ESP-La Liga,2425,Las Palmas,Dario Essugo,,,19.0,2005.0,21.5,59,45,28,26,5,28,46,60.9,18,28,11,17,42,101,47,7
ESP-La Liga,2425,Las Palmas,Diego Martín,,,20.0,2003.0,0.4,1,1,0,0,1,1,1,100.0,0,0,0,0,0,1,1,0
ESP-La Liga,2425,Las Palmas,Dinko Horkaš,,,25.0,1999.0,12.1,0,0,0,0,0,0,0,,0,0,0,0,0,0,9,1
ESP-La Liga,2425,Las Palmas,Enzo Loiodice,,,23.0,2000.0,7.6,17,7,8,9,0,3,10,30.0,7,4,1,3,10,27,7,2
ESP-La Liga,2425,Las Palmas,Fabio González,,,27.0,1997.0,0.6,0,0,0,0,0,0,1,0.0,1,0,0,0,0,0,0,0
ESP-La Liga,2425,Las Palmas,Fábio Silva,,,22.0,2002.0,20.7,12,7,4,5,3,4,14,28.6,10,12,0,12,4,16,27,0
ESP-La Liga,2425,Las Palmas,Jaime Mata,,,35.0,1988.0,7.3,8,2,2,6,0,3,9,33.3,6,5,1,4,3,11,11,0
ESP-La Liga,2425,Las Palmas,Jasper Cillessen,,,35.0,1989.0,25.9,1,0,1,0,0,1,4,25.0,3,0,0,0,0,1,11,2
ESP-La Liga,2425,Las Palmas,Javier Muñoz,,,29.0,1995.0,28.8,45,35,18,17,10,16,46,34.8,30,27,4,23,31,76,39,3
ESP-La Liga,2425,Las Palmas,José Campaña,,,31.0,1993.0,13.2,21,16,8,11,2,11,20,55.0,9,9,1,8,19,40,19,2
ESP-La Liga,2425,Las Palmas,José Carlos González,,,18.0,2006.0,0.1,0,0,0,0,0,0,0,,0,0,0,0,0,0,0,0
ESP-La Liga,2425,Las Palmas,Juan Herzog,,,21.0,2003.0,14.6,12,12,12,0,0,9,16,56.3,7,17,11,6,18,30,86,0
ESP-La Liga,2425,Las Palmas,Kirian Rodríguez,,,28.0,1996.0,19.5,33,17,12,18,3,22,43,51.2,21,22,4,18,10,43,21,0
ESP-La Liga,2425,Las Palmas,Manuel Fuster,,,26.0,1997.0,11.1,19,11,5,8,6,15,28,53.6,13,13,3,10,4,23,17,0
ESP-La Liga,2425,Las Palmas,Marc Cardona,,,29.0,1995.0,1.5,4,2,1,3,0,0,1,0.0,1,0,0,0,0,4,0,0
ESP-La Liga,2425,Las Palmas,Marvin,,,24.0,2000.0,11.5,25,13,12,9,4,11,26,42.3,15,17,6,11,15,40,34,0
ESP-La Liga,2425,Las Palmas,Mika Mármol,,,23.0,2001.0,26.7,61,29,35,24,2,34,52,65.4,18,46,14,32,38,99,121,2
ESP-La Liga,2425,Las Palmas,Oliver McBurnie,,,28.0,1996.0,20.4,15,7,5,8,2,5,12,41.7,7,15,5,10,6,21,24,0
ESP-La Liga,2425,Las Palmas,Pejiño,,,28.0,1996.0,0.2,1,1,0,1,0,1,1,100.0,0,0,0,0,0,1,0,0
ESP-La Liga,2425,Las Palmas,Sandro Ramírez,,,29.0,1995.0,22.6,27,15,10,13,4,13,30,43.3,17,20,0,20,16,43,22,2
ESP-La Liga,2425,Las Palmas,Scott McKenna,,,27.0,1996.0,27.4,21,13,16,5,0,9,12,75.0,3,36,28,8,9,30,163,2
ESP-La Liga,2425,Las Palmas,Sergio Viera,,,19.0,2005.0,1.1,1,1,0,1,0,0,1,0.0,1,1,0,1,1,2,1,0
ESP-La Liga,2425,Las Palmas,Stefan Bajcetic,,,19.0,2004.0,10.8,29,14,13,13,3,12,28,42.9,16,25,4,21,15,44,26,1
ESP-La Liga,2425,Las Palmas,Valentín Pezzolesi,,,17.0,2007.0,0.1,0,0,0,0,0,0,0,,0,0,0,0,0,0,1,1
ESP-La Liga,2425,Las Palmas,Viti,,,26.0,1997.0,22.0,71,46,43,21,7,31,45,68.9,14,28,7,21,27,98,61,0
ESP-La Liga,2425,Las Palmas,Álex Muñoz,,,30.0,1994.0,15.7,39,29,22,16,1,21,38,55.3,17,28,11,17,16,55,69,0
ESP-La Liga,2425,Las Palmas,Álex Suárez,,,31.0,1993.0,27.3,40,23,30,9,1,20,27,74.1,7,39,24,15,13,53,107,2
ESP-La Liga,2425,Leganés,Adrià Altimira,,,23.0,2001.0,18.1,41,24,26,12,3,24,40,60.0,16,15,6,9,15,56,54,2
ESP-La Liga,2425,Leganés,Aritz Arambarri,,,26.0,1998.0,2.0,1,1,1,0,0,1,1,100.0,0,2,2,0,3,4,8,0
ESP-La Liga,2425,Leganés,Borna Barišić,,,31.0,1992.0,0.1,0,0,0,0,0,0,0,,0,0,0,0,0,0,0,0
ESP-La Liga,2425,Leganés,Dani Raba,,,28.0,1995.0,20.9,37,23,17,15,5,17,42,40.5,25,27,3,24,14,51,19,1
ESP-La Liga,2425,Leganés,Darko Brašanac,,,32.0,1992.0,18.0,26,11,5,15,6,9,17,52.9,8,24,11,13,16,42,34,0
ESP-La Liga,2425,Leganés,Diego,,,24.0,2000.0,13.3,1,1,0,0,1,1,7,14.3,6,4,1,3,2,3,11,0
ESP-La Liga,2425,Leganés,Duk,,,24.0,2000.0,2.0,8,4,3,3,2,3,5,60.0,2,4,0,4,1,9,2,0
ESP-La Liga,2425,Leganés,Enric Franquesa,,,27.0,1997.0,6.8,17,9,9,6,2,9,13,69.2,4,7,1,6,5,22,12,0
ESP-La Liga,2425,Leganés,Javi Hernández,,,26.0,1998.0,26.5,26,15,16,7,3,17,46,37.0,29,25,5,20,23,49,98,0
ESP-La Liga,2425,Leganés,Jorge Sáenz,,,27.0,1996.0,18.8,37,23,18,18,1,11,20,55.0,9,26,17,9,25,62,161,0
ESP-La Liga,2425,Leganés,Juan Cruz,,,24.0,2000.0,25.1,32,19,14,16,2,17,35,48.6,18,18,2,16,13,45,31,0
ESP-La Liga,2425,Leganés,Juan Soriano,,,26.0,1997.0,6.0,1,1,1,0,0,1,1,100.0,0,0,0,0,0,1,2,0
ESP-La Liga,2425,Leganés,Julián Chicco,,,26.0,1998.0,3.4,11,7,3,6,2,5,8,62.5,3,2,0,2,4,15,10,0
ESP-La Liga,2425,Leganés,Marko Dmitrović,,,32.0,1992.0,32.0,1,1,1,0,0,1,2,50.0,1,0,0,0,0,1,27,3
ESP-La Liga,2425,Leganés,Matija Nastasić,,,31.0,1993.0,23.4,25,11,21,4,0,17,25,68.0,8,39,30,9,21,46,165,0
ESP-La Liga,2425,Leganés,Miguel,,,24.0,1999.0,19.2,16,7,6,4,6,4,14,28.6,10,15,4,11,4,20,23,1
ESP-La Liga,2425,Leganés,Munir El Haddadi,,,28.0,1995.0,9.6,12,9,5,4,3,3,12,25.0,9,8,1,7,1,13,1,1
ESP-La Liga,2425,Leganés,Renato Tapia,,,29.0,1995.0,26.9,61,35,30,27,4,24,50,48.0,26,58,23,35,27,88,86,2
ESP-La Liga,2425,Leganés,Roberto López,,,24.0,2000.0,4.4,8,6,4,4,0,5,15,33.3,10,5,0,5,1,9,7,2
ESP-La Liga,2425,Leganés,Sergi,,,32.0,1992.0,32.9,40,29,22,16,2,18,32,56.3,14,38,29,9,39,79,185,2
ESP-La Liga,2425,Leganés,Seydouba Cissé,,,23.0,2001.0,27.1,59,37,18,27,14,23,50,46.0,27,25,1,24,12,71,45,1
ESP-La Liga,2425,Leganés,Sébastien Haller,,,30.0,1994.0,4.5,2,0,1,0,1,1,2,50.0,1,1,0,1,0,2,7,0
ESP-La Liga,2425,Leganés,Valentin Rosier,,,27.0,1996.0,28.8,72,52,48,16,8,43,68,63.2,25,40,15,25,52,124,149,2
ESP-La Liga,2425,Leganés,Yan Diomandé,,,17.0,2006.0,6.1,14,9,1,8,5,5,15,33.3,10,8,0,8,8,22,6,0
ESP-La Liga,2425,Leganés,Yvan Neyou,,,27.0,1997.0,25.7,53,33,21,26,6,22,47,46.8,25,35,5,30,26,79,38,1
ESP-La Liga,2425,Leganés,Óscar Rodríguez Arnaiz,,,26.0,1998.0,14.8,32,17,10,16,6,14,32,43.8,18,10,1,9,20,52,20,0
ESP-La Liga,2425,Mallorca,Abdón Prats,,,31.0,1992.0,5.1,2,1,1,1,0,1,2,50.0,1,2,1,1,1,3,5,0
ESP-La Liga,2425,Mallorca,Antonio Raillo,,,32.0,1991.0,35.6,31,18,18,10,3,14,20,70.0,6,51,38,13,29,60,222,1
ESP-La Liga,2425,Mallorca,Antonio Sánchez,,,27.0,1997.0,15.5,28,16,16,8,4,14,36,38.9,22,16,2,14,18,46,36,1
ESP-La Liga,2425,Mallorca,Chiquinho,,,24.0,2000.0,1.6,1,0,0,1,0,0,7,0.0,7,3,0,3,2,3,0,0
ESP-La Liga,2425,Mallorca,Copete,,,24.0,1999.0,17.0,29,17,18,10,1,11,12,91.7,1,24,16,8,17,46,123,2
ESP-La Liga,2425,Mallorca,Cyle Larin,,,29.0,1995.0,19.6,12,6,1,6,5,3,9,33.3,6,12,3,9,1,13,16,0
ESP-La Liga,2425,Mallorca,Dani Rodríguez,,,36.0,1988.0,24.0,49,29,18,21,10,14,27,51.9,13,22,3,19,12,61,30,0
ESP-La Liga,2425,Mallorca,Daniel Luna,,,21.0,2003.0,0.2,0,0,0,0,0,0,0,,0,1,0,1,0,0,0,0
ESP-La Liga,2425,Mallorca,David López,,,21.0,2003.0,1.9,3,2,3,0,0,2,2,100.0,0,2,2,0,1,4,10,0
ESP-La Liga,2425,Mallorca,Dominik Greif,,,27.0,1997.0,31.0,0,0,0,0,0,0,0,,0,0,0,0,0,0,13,1
ESP-La Liga,2425,Mallorca,Jan Salas,,,18.0,2005.0,0.5,3,1,2,1,0,2,2,100.0,0,0,0,0,0,3,0,0
ESP-La Liga,2425,Mallorca,Javier Llabrés,,,21.0,2002.0,0.6,0,0,0,0,0,0,0,,0,1,0,1,0,0,0,0
ESP-La Liga,2425,Mallorca,Johan Mojica,,,31.0,1992.0,30.6,35,23,26,6,3,19,40,47.5,21,13,5,8,26,61,84,3
ESP-La Liga,2425,Mallorca,Leo Román,,,24.0,2000.0,7.0,0,0,0,0,0,0,0,,0,0,0,0,0,0,6,0
ESP-La Liga,2425,Mallorca,Manu Morlanes,,,25.0,1999.0,14.9,43,27,18,20,5,18,30,60.0,12,19,8,11,24,67,16,0
ESP-La Liga,2425,Mallorca,Marc Domenech,,,18.0,2006.0,3.4,4,4,2,1,1,2,5,40.0,3,2,0,2,0,4,2,0
ESP-La Liga,2425,Mallorca,Martin Valjent,,,28.0,1995.0,30.7,30,21,22,7,1,15,25,60.0,10,32,21,11,18,48,195,1
ESP-La Liga,2425,Mallorca,Mateu Morey,,,24.0,2000.0,8.2,22,18,13,6,3,12,22,54.5,10,11,0,11,15,37,32,2
ESP-La Liga,2425,Mallorca,Omar Mascarell,,,31.0,1993.0,22.1,27,13,13,13,1,14,35,40.0,21,33,21,12,49,76,59,3
ESP-La Liga,2425,Mallorca,Pablo Maffeo,,,27.0,1997.0,26.3,60,40,43,14,3,34,46,73.9,12,32,11,21,25,85,103,1
ESP-La Liga,2425,Mallorca,Roberto Navarro,,,22.0,2002.0,14.2,29,22,14,11,4,9,19,47.4,10,18,0,18,19,48,12,0
ESP-La Liga,2425,Mallorca,Samu Costa,,,23.0,2000.0,29.4,90,44,45,42,3,35,79,44.3,44,48,15,33,32,122,85,1
ESP-La Liga,2425,Mallorca,Sergi Darder,,,30.0,1993.0,30.5,40,26,15,16,9,17,46,37.0,29,19,1,18,16,56,23,1
ESP-La Liga,2425,Mallorca,Siebe Van Der Heyden,,,26.0,1998.0,1.1,1,1,0,1,0,0,0,,0,1,0,1,2,3,3,0
ESP-La Liga,2425,Mallorca,Takuma Asano,,,29.0,1994.0,11.7,13,9,5,7,1,6,11,54.5,5,7,0,7,6,19,9,0
ESP-La Liga,2425,Mallorca,Toni Lato,,,26.0,1997.0,6.9,17,11,6,5,6,7,11,63.6,4,10,4,6,6,23,33,0
ESP-La Liga,2425,Mallorca,Valery Fernández,,,24.0,1999.0,3.4,8,7,3,2,3,5,7,71.4,2,3,1,2,0,8,1,0
ESP-La Liga,2425,Mallorca,Vedat Muriqi,,,30.0,1994.0,22.9,7,5,3,2,2,3,7,42.9,4,7,1,6,7,14,43,0
ESP-La Liga,2425,Osasuna,Abel,,,23.0,2000.0,23.0,61,37,28,25,8,39,63,61.9,24,29,4,25,18,79,64,2
ESP-La Liga,2425,Osasuna,Aimar Oroz,,,22.0,2001.0,33.0,35,19,16,13,6,14,46,30.4,32,29,2,27,20,55,10,0
ESP-La Liga,2425,Osasuna,Aitor Fernández,,,33.0,1991.0,1.0,0,0,0,0,0,0,0,,0,0,0,0,0,0,2,0
ESP-La Liga,2425,Osasuna,Ante Budimir,,,33.0,1991.0,32.8,20,9,3,11,6,3,13,23.1,10,19,4,15,2,22,26,0
ESP-La Liga,2425,Osasuna,Bryan Zaragoza,,,23.0,2001.0,20.4,13,9,8,4,1,6,21,28.6,15,10,0,10,4,17,8,0
ESP-La Liga,2425,Osasuna,Catena,,,29.0,1994.0,34.2,46,28,34,10,2,27,44,61.4,17,40,25,15,35,81,221,2
ESP-La Liga,2425,Osasuna,Enzo Boyomo,,,22.0,2001.0,33.2,68,43,46,18,4,30,39,76.9,9,34,19,15,44,112,137,3
ESP-La Liga,2425,Osasuna,Iker Benito,,,21.0,2002.0,0.4,0,0,0,0,0,0,1,0.0,1,0,0,0,1,1,2,0
ESP-La Liga,2425,Osasuna,Iker Muñoz,,,21.0,2002.0,6.8,5,2,3,2,0,3,9,33.3,6,9,2,7,4,9,12,1
ESP-La Liga,2425,Osasuna,Javi Martínez,,,24.0,1999.0,0.1,0,0,0,0,0,0,0,,0,0,0,0,0,0,0,0
ESP-La Liga,2425,Osasuna,Jesús Areso,,,25.0,1999.0,34.2,53,38,31,14,8,39,56,69.6,17,26,4,22,8,61,92,0
ESP-La Liga,2425,Osasuna,Jon Moncayola,,,26.0,1998.0,23.3,70,41,29,33,8,31,60,51.7,29,34,3,31,11,81,20,0
ESP-La Liga,2425,Osasuna,Jorge Herrando,,,23.0,2001.0,15.2,17,11,9,5,3,9,15,60.0,6,20,14,6,12,29,65,2
ESP-La Liga,2425,Osasuna,José Arnaiz,,,29.0,1995.0,1.5,7,5,3,3,1,4,7,57.1,3,2,0,2,5,12,1,0
ESP-La Liga,2425,Osasuna,Juan Cruz Armada,,,32.0,1992.0,16.6,26,14,11,13,2,15,24,62.5,9,15,4,11,9,35,68,0
ESP-La Liga,2425,Osasuna,Kike Barja,,,27.0,1997.0,3.5,5,4,1,3,1,2,4,50.0,2,5,0,5,3,8,4,0
ESP-La Liga,2425,Osasuna,Lucas Torró,,,30.0,1994.0,32.9,74,41,34,35,5,36,64,56.3,28,36,9,27,45,119,70,3
ESP-La Liga,2425,Osasuna,Moi Gómez,,,30.0,1994.0,8.8,13,9,4,7,2,4,8,50.0,4,5,2,3,6,19,7,1
ESP-La Liga,2425,Osasuna,Nacho Vidal,,,29.0,1995.0,1.4,2,0,0,1,1,1,4,25.0,3,1,0,1,0,2,6,0
ESP-La Liga,2425,Osasuna,Pablo Ibáñez,,,25.0,1998.0,14.4,20,10,7,12,1,10,40,25.0,30,20,7,13,18,38,21,0
ESP-La Liga,2425,Osasuna,Raúl,,,23.0,2000.0,8.3,13,8,3,6,4,5,10,50.0,5,4,0,4,0,13,6,0
ESP-La Liga,2425,Osasuna,Rubén García,,,31.0,1993.0,26.8,52,31,20,21,11,26,60,43.3,34,37,3,34,15,67,34,1
ESP-La Liga,2425,Osasuna,Rubén Peña,,,33.0,1991.0,8.6,12,5,4,3,5,5,24,20.8,19,11,0,11,6,18,12,0
ESP-La Liga,2425,Osasuna,Sergio Herrera,,,31.0,1993.0,37.0,2,1,2,0,0,2,6,33.3,4,1,0,1,0,2,29,1
ESP-La Liga,2425,Osasuna,Unai García,,,32.0,1992.0,0.7,0,0,0,0,0,0,0,,0,1,0,1,0,0,1,0
ESP-La Liga,2425,Rayo Vallecano,Abdul Mumin,,,26.0,1998.0,22.4,37,25,30,7,0,17,27,63.0,10,40,29,11,23,60,125,0
ESP-La Liga,2425,Rayo Vallecano,Adri Embarba,,,32.0,1992.0,17.9,41,20,17,17,7,18,47,38.3,29,18,1,17,13,54,14,2
ESP-La Liga,2425,Rayo Vallecano,Alfonso Espino,,,32.0,1992.0,9.3,41,24,31,8,2,26,47,55.3,21,19,6,13,12,53,32,1
ESP-La Liga,2425,Rayo Vallecano,Andrei Ratiu,,,26.0,1998.0,34.1,71,41,40,21,10,42,70,60.0,28,45,5,40,27,98,73,2
ESP-La Liga,2425,Rayo Vallecano,Aridane Hernández,,,35.0,1989.0,11.4,13,11,9,4,0,6,8,75.0,2,10,8,2,6,19,99,2
ESP-La Liga,2425,Rayo Vallecano,Augusto Batalla,,,28.0,1996.0,32.0,4,2,4,0,0,4,6,66.7,2,0,0,0,0,4,15,4
ESP-La Liga,2425,Rayo Vallecano,Dani Cárdenas,,,27.0,1997.0,6.0,0,0,0,0,0,0,0,,0,0,0,0,0,0,3,0
ESP-La Liga,2425,Rayo Vallecano,Etienne Eto'o,,,21.0,2002.0,0.4,0,0,0,0,0,0,1,0.0,1,0,0,0,0,0,1,0
ESP-La Liga,2425,Rayo Vallecano,Florian Lejeune,,,33.0,1991.0,36.9,46,28,30,14,2,23,43,53.5,20,38,32,6,41,87,181,1
ESP-La Liga,2425,Rayo Vallecano,Gerard Gumbau,,,29.0,1994.0,9.4,17,12,8,7,2,7,15,46.7,8,13,4,9,5,22,13,0
ESP-La Liga,2425,Rayo Vallecano,Isaac Palazón Camacho,,,29.0,1994.0,24.0,22,17,10,6,6,8,34,23.5,26,22,3,19,8,30,13,1
ESP-La Liga,2425,Rayo Vallecano,Iván Balliu,,,32.0,1992.0,13.3,17,14,8,5,4,6,18,33.3,12,16,4,12,13,30,39,0
ESP-La Liga,2425,Rayo Vallecano,James Rodríguez,,,33.0,1991.0,1.6,3,2,1,2,0,0,2,0.0,2,2,0,2,1,4,0,0
ESP-La Liga,2425,Rayo Vallecano,Jorge de Frutos,,,27.0,1997.0,27.7,37,21,16,13,8,14,46,30.4,32,22,0,22,19,56,24,1
ESP-La Liga,2425,Rayo Vallecano,Pathé Ciss,,,30.0,1994.0,23.8,49,24,26,22,1,20,41,48.8,21,31,10,21,40,89,61,3
ESP-La Liga,2425,Rayo Vallecano,Pedro Díaz,,,26.0,1998.0,13.5,23,15,7,14,2,14,41,34.1,27,16,0,16,7,30,7,1
ESP-La Liga,2425,Rayo Vallecano,Pelayo Fernandez,,,21.0,2003.0,1.1,0,0,0,0,0,0,0,,0,0,0,0,2,2,9,0
ESP-La Liga,2425,Rayo Vallecano,Pep Chavarría,,,26.0,1998.0,28.7,46,36,30,14,2,28,45,62.2,17,35,9,26,30,76,108,1
ESP-La Liga,2425,Rayo Vallecano,Randy Nteka,,,26.0,1997.0,12.5,16,5,3,9,4,5,12,41.7,7,13,2,11,4,20,20,0
ESP-La Liga,2425,Rayo Vallecano,Raúl de Tomás,,,29.0,1994.0,0.2,2,2,1,0,1,0,0,,0,0,0,0,0,2,0,0
ESP-La Liga,2425,Rayo Vallecano,Sergi Guardiola,,,33.0,1991.0,4.0,5,3,0,5,0,2,3,66.7,1,1,0,1,1,6,2,0
ESP-La Liga,2425,Rayo Vallecano,Sergio Camello,,,23.0,2001.0,12.6,9,3,2,5,2,4,6,66.7,2,8,1,7,4,13,16,0
ESP-La Liga,2425,Rayo Vallecano,Unai López,,,28.0,1995.0,19.0,31,21,14,12,5,17,36,47.2,19,18,6,12,21,52,20,0
ESP-La Liga,2425,Rayo Vallecano,Álvaro García,,,31.0,1992.0,28.4,33,24,19,8,6,12,31,38.7,19,31,0,31,32,65,42,1
ESP-La Liga,2425,Rayo Vallecano,Óscar Trejo,,,36.0,1988.0,5.5,8,5,1,5,2,3,9,33.3,6,9,0,9,4,12,5,0
ESP-La Liga,2425,Rayo Vallecano,Óscar Valentín,,,29.0,1994.0,20.4,55,41,21,20,14,33,76,43.4,43,36,8,28,21,76,51,2
ESP-La Liga,2425,Real Madrid,Andriy Lunin,,,25.0,1999.0,7.0,1,0,1,0,0,0,0,,0,0,0,0,0,1,3,0
ESP-La Liga,2425,Real Madrid,Antonio Rüdiger,,,31.0,1993.0,25.5,20,13,14,6,0,11,15,73.3,4,22,14,8,9,29,96,1
ESP-La Liga,2425,Real Madrid,Arda Güler,,,19.0,2005.0,13.9,30,16,11,8,11,9,22,40.9,13,18,0,18,7,37,8,0
ESP-La Liga,2425,Real Madrid,Aurélien Tchouaméni,,,24.0,2000.0,29.9,47,23,25,19,3,21,41,51.2,20,34,25,9,46,93,92,1
ESP-La Liga,2425,Real Madrid,Brahim Díaz,,,24.0,1999.0,15.4,25,19,9,13,3,7,19,36.8,12,16,1,15,4,29,2,1
ESP-La Liga,2425,Real Madrid,Chema,,,19.0,2005.0,0.1,0,0,0,0,0,0,0,,0,0,0,0,0,0,1,0
ESP-La Liga,2425,Real Madrid,Dani Carvajal,,,32.0,1992.0,6.8,12,8,7,3,2,9,12,75.0,3,8,3,5,10,22,19,1
ESP-La Liga,2425,Real Madrid,Dani Ceballos,,,27.0,1996.0,13.5,41,21,17,18,6,20,40,50.0,20,16,4,12,14,55,10,2
ESP-La Liga,2425,Real Madrid,Daniel Yáñez,,,17.0,2007.0,0.0,0,0,0,0,0,0,0,,0,0,0,0,0,0,0,0
ESP-La Liga,2425,Real Madrid,David Alaba,,,32.0,1992.0,3.5,1,0,1,0,0,0,0,,0,5,5,0,6,7,7,0
ESP-La Liga,2425,Real Madrid,Eduardo Camavinga,,,21.0,2002.0,12.2,42,26,23,16,3,19,33,57.6,14,24,8,16,18,60,23,0
ESP-La Liga,2425,Real Madrid,Endrick,,,18.0,2006.0,4.0,1,1,1,0,0,1,3,33.3,2,0,0,0,4,5,1,0
ESP-La Liga,2425,Real Madrid,Federico Valverde,,,26.0,1998.0,33.7,50,30,22,23,5,29,43,67.4,14,38,8,30,55,105,52,1
ESP-La Liga,2425,Real Madrid,Ferland Mendy,,,29.0,1995.0,11.2,17,14,7,6,4,9,12,75.0,3,11,4,7,9,26,8,1
ESP-La Liga,2425,Real Madrid,Fran,,,19.0,2005.0,1.0,0,0,0,0,0,0,0,,0,0,0,0,0,0,2,0
ESP-La Liga,2425,Real Madrid,Fran Garcia,,,24.0,1999.0,24.1,51,36,29,16,6,28,51,54.9,23,27,5,22,28,79,67,1
ESP-La Liga,2425,Real Madrid,Gonzalo García,,,20.0,2004.0,0.6,0,0,0,0,0,0,0,,0,1,0,1,0,0,0,0
ESP-La Liga,2425,Real Madrid,Jacobo Ramón,,,19.0,2005.0,2.3,7,3,4,3,0,2,2,100.0,0,1,0,1,3,10,8,2
ESP-La Liga,2425,Real Madrid,Jesús Vallejo,,,27.0,1997.0,1.5,0,0,0,0,0,0,0,,0,0,0,0,2,2,8,0
ESP-La Liga,2425,Real Madrid,Jude Bellingham,,,21.0,2003.0,27.6,61,33,20,27,14,28,42,66.7,14,37,2,35,28,89,23,1
ESP-La Liga,2425,Real Madrid,Kylian Mbappé,,,25.0,1998.0,32.3,8,5,1,3,4,1,5,20.0,4,3,0,3,1,9,1,1
ESP-La Liga,2425,Real Madrid,Lorenzo Aguado,,,21.0,2002.0,0.1,0,0,0,0,0,0,0,,0,0,0,0,0,0,2,0
ESP-La Liga,2425,Real Madrid,Lucas Vázquez,,,33.0,1991.0,24.3,58,34,33,17,8,27,48,56.3,21,24,6,18,17,75,35,1
ESP-La Liga,2425,Real Madrid,Luka Modrić,,,38.0,1985.0,20.3,31,20,16,13,2,14,32,43.8,18,17,5,12,27,58,17,0
ESP-La Liga,2425,Real Madrid,Raúl Asencio,,,21.0,2003.0,18.6,22,16,18,4,0,10,13,76.9,3,11,6,5,16,38,88,2
ESP-La Liga,2425,Real Madrid,Rodrygo,,,23.0,2001.0,21.4,21,14,14,5,2,7,23,30.4,16,18,1,17,11,32,9,0
ESP-La Liga,2425,Real Madrid,Thibaut Courtois,,,32.0,1992.0,30.0,0,0,0,0,0,0,0,,0,0,0,0,1,1,15,1
ESP-La Liga,2425,Real Madrid,Vinicius Júnior,,,24.0,2000.0,25.0,21,10,7,4,10,5,18,27.8,13,9,0,9,3,24,1,2
ESP-La Liga,2425,Real Madrid,Víctor Muñoz,,,21.0,2003.0,0.4,0,0,0,0,0,0,0,,0,0,0,0,0,0,0,0
ESP-La Liga,2425,Real Madrid,Éder Militão,,,26.0,1998.0,10.4,19,17,14,5,0,7,12,58.3,5,13,8,5,12,31,35,0
ESP-La Liga,2425,Real Sociedad,Aihen Muñoz,,,26.0,1997.0,12.2,24,12,14,8,2,14,28,50.0,14,11,6,5,14,38,47,0
ESP-La Liga,2425,Real Sociedad,Ander Barrenetxea,,,22.0,2001.0,14.0,26,19,7,14,5,6,23,26.1,17,15,0,15,11,37,16,1
ESP-La Liga,2425,Real Sociedad,Aritz Elustondo,,,30.0,1994.0,16.2,20,11,15,3,2,11,19,57.9,8,17,12,5,11,31,96,0
ESP-La Liga,2425,Real Sociedad,Arkaitz Mariezkurrena,,,19.0,2005.0,2.7,1,0,1,0,0,0,4,0.0,4,4,1,3,1,2,4,0
ESP-La Liga,2425,Real Sociedad,Arsen Zakharyan,,,21.0,2003.0,0.8,1,1,1,0,0,1,1,100.0,0,1,1,0,1,2,0,0
ESP-La Liga,2425,Real Sociedad,Beñat Turrientes,,,22.0,2002.0,10.5,15,6,4,10,1,4,15,26.7,11,15,3,12,5,20,14,1
ESP-La Liga,2425,Real Sociedad,Brais Méndez,,,27.0,1997.0,17.0,24,13,6,14,4,9,24,37.5,15,14,1,13,7,31,16,1
ESP-La Liga,2425,Real Sociedad,Daniel Díaz,,,18.0,2006.0,0.1,1,1,1,0,0,0,0,,0,1,0,1,0,1,0,0
ESP-La Liga,2425,Real Sociedad,Hamari Traoré,,,32.0,1992.0,7.8,19,12,10,7,2,15,22,68.2,7,6,2,4,9,28,21,0
ESP-La Liga,2425,Real Sociedad,Igor Zubeldia,,,27.0,1997.0,25.2,34,22,21,10,3,14,26,53.8,12,32,18,14,31,65,100,2
ESP-La Liga,2425,Real Sociedad,Javi López,,,22.0,2002.0,21.5,40,23,23,12,5,23,37,62.2,14,21,7,14,11,51,59,2
ESP-La Liga,2425,Real Sociedad,Jon Aramburu,,,22.0,2002.0,27.3,102,70,61,30,11,66,100,66.0,34,40,8,32,30,132,98,0
ESP-La Liga,2425,Real Sociedad,Jon Magunazelaia,,,23.0,2001.0,0.1,1,1,1,0,0,0,0,,0,0,0,0,0,1,0,0
ESP-La Liga,2425,Real Sociedad,Jon Martin,,,18.0,2006.0,10.0,11,9,7,3,1,6,9,66.7,3,13,9,4,7,18,80,1
ESP-La Liga,2425,Real Sociedad,Jon Pacheco,,,23.0,2001.0,9.5,15,9,12,3,0,10,12,83.3,2,8,6,2,9,24,49,2
ESP-La Liga,2425,Real Sociedad,Luka Sučić,,,21.0,2002.0,19.9,25,18,8,12,5,10,26,38.5,16,30,2,28,15,40,16,1
ESP-La Liga,2425,Real Sociedad,Luken Beitia,,,20.0,2004.0,0.1,1,1,1,0,0,1,1,100.0,0,0,0,0,0,1,2,0
ESP-La Liga,2425,Real Sociedad,Martín Zubimendi,,,25.0,1999.0,32.9,73,37,31,29,13,28,44,63.6,16,42,16,26,44,117,79,3
ESP-La Liga,2425,Real Sociedad,Mikel Oyarzabal,,,27.0,1997.0,25.0,25,16,9,10,6,10,23,43.5,13,17,1,16,4,29,15,0
ESP-La Liga,2425,Real Sociedad,Nayef Aguerd,,,28.0,1996.0,19.6,30,24,17,12,1,12,18,66.7,6,21,15,6,13,43,91,0
ESP-La Liga,2425,Real Sociedad,Olasagasti,,,23.0,2000.0,9.5,21,10,7,9,5,8,18,44.4,10,8,2,6,15,36,10,0
ESP-La Liga,2425,Real Sociedad,Orri Steinn Óskarsson,,,19.0,2004.0,10.5,6,6,2,1,3,2,8,25.0,6,10,1,9,2,8,11,0
ESP-La Liga,2425,Real Sociedad,Pablo Marín,,,21.0,2003.0,13.8,25,17,6,13,6,10,19,52.6,9,12,3,9,5,30,14,0
ESP-La Liga,2425,Real Sociedad,Sergio Gómez,,,23.0,2000.0,30.4,71,39,30,29,12,30,56,53.6,26,44,3,41,19,90,30,2
ESP-La Liga,2425,Real Sociedad,Sheraldo Becker,,,29.0,1995.0,11.1,3,2,0,3,0,0,2,0.0,2,4,0,4,1,4,10,0
ESP-La Liga,2425,Real Sociedad,Takefusa Kubo,,,23.0,2001.0,26.4,31,20,11,11,9,16,40,40.0,24,38,1,37,17,48,13,1
ESP-La Liga,2425,Real Sociedad,Umar Sadiq,,,27.0,1997.0,2.5,2,1,1,1,0,1,2,50.0,1,3,1,2,1,3,2,0
ESP-La Liga,2425,Real Sociedad,Unai Marrero,,,22.0,2001.0,2.0,0,0,0,0,0,0,0,,0,0,0,0,0,0,1,0
ESP-La Liga,2425,Real Sociedad,Urko González,,,23.0,2001.0,0.5,0,0,0,0,0,0,0,,0,1,1,0,0,0,0,0
ESP-La Liga,2425,Real Sociedad,Álex Remiro,,,29.0,1995.0,36.0,1,0,1,0,0,1,2,50.0,1,0,0,0,0,1,18,4
ESP-La Liga,2425,Real Sociedad,Álvaro Odriozola,,,28.0,1995.0,0.5,1,1,1,0,0,0,0,,0,0,0,0,0,1,1,0
ESP-La Liga,2425,Sevilla,Adrià Pedrosa,,,26.0,1998.0,25.5,56,32,34,16,6,31,54,57.4,23,43,11,32,24,80,85,0
ESP-La Liga,2425,Sevilla,Akor Adams,,,24.0,2000.0,1.5,0,0,0,0,0,0,0,,0,1,0,1,0,0,1,0
ESP-La Liga,2425,Sevilla,Albert Sambi Lokonga,,,24.0,1999.0,16.3,22,15,10,9,3,10,14,71.4,4,13,1,12,9,31,24,3
ESP-La Liga,2425,Sevilla,Carmona,,,22.0,2002.0,32.7,83,59,53,21,9,41,77,53.2,36,37,11,26,68,151,92,3
ESP-La Liga,2425,Sevilla,Chidera Ejuke,,,26.0,1998.0,10.7,19,13,8,9,2,9,20,45.0,11,12,0,12,5,24,8,0
ESP-La Liga,2425,Sevilla,Darío Fuentes,,,21.0,2003.0,0.1,0,0,0,0,0,0,0,,0,0,0,0,0,0,0,0
ESP-La Liga,2425,Sevilla,Diego Iturralde,,,21.0,2003.0,0.4,0,0,0,0,0,0,0,,0,0,0,0,1,1,1,0
ESP-La Liga,2425,Sevilla,Djibril Sow,,,27.0,1997.0,22.9,25,14,13,10,2,8,17,47.1,9,18,3,15,28,53,26,1
ESP-La Liga,2425,Sevilla,Dodi Lukebakio,,,26.0,1997.0,34.4,22,14,8,8,6,15,27,55.6,12,18,1,17,11,33,17,2
ESP-La Liga,2425,Sevilla,Gonzalo Montiel,,,27.0,1997.0,1.3,4,2,3,1,0,3,4,75.0,1,0,0,0,2,6,11,0
ESP-La Liga,2425,Sevilla,Isaac Romero,,,24.0,2000.0,24.0,13,7,4,4,5,3,16,18.8,13,18,1,17,7,20,27,0
ESP-La Liga,2425,Sevilla,Israel Domínguez,,,21.0,2003.0,0.2,0,0,0,0,0,0,0,,0,0,0,0,0,0,0,0
ESP-La Liga,2425,Sevilla,Jesús Navas,,,38.0,1985.0,4.7,5,2,3,0,2,0,3,0.0,3,1,0,1,4,9,6,0
ESP-La Liga,2425,Sevilla,Juanlu Sánchez,,,20.0,2003.0,19.1,50,34,28,15,7,35,59,59.3,24,27,2,25,17,67,19,0
ESP-La Liga,2425,Sevilla,Kelechi Iheanacho,,,27.0,1996.0,4.4,1,0,0,1,0,1,3,33.3,2,0,0,0,0,1,1,0
ESP-La Liga,2425,Sevilla,Kike Salas,,,22.0,2002.0,24.9,47,28,24,16,7,27,46,58.7,19,26,14,12,32,79,146,0
ESP-La Liga,2425,Sevilla,Leandro Antonetti,,,21.0,2003.0,0.3,0,0,0,0,0,0,0,,0,0,0,0,0,0,0,0
ESP-La Liga,2425,Sevilla,Loïc Bade,,,24.0,2000.0,29.8,47,27,37,10,0,23,31,74.2,8,22,13,9,29,76,162,2
ESP-La Liga,2425,Sevilla,Lucas Ocampos,,,30.0,1994.0,1.9,3,2,2,0,1,1,2,50.0,1,2,0,2,0,3,2,0
ESP-La Liga,2425,Sevilla,Lucien Agoume,,,22.0,2002.0,23.5,70,32,23,37,10,27,39,69.2,12,30,11,19,41,111,42,0
ESP-La Liga,2425,Sevilla,Manu Bueno,,,20.0,2004.0,1.6,4,3,0,1,3,1,2,50.0,1,0,0,0,0,4,2,0
ESP-La Liga,2425,Sevilla,Marcão,,,28.0,1996.0,6.1,10,7,6,4,0,3,5,60.0,2,9,6,3,7,17,29,1
ESP-La Liga,2425,Sevilla,Mateo Mejía,,,21.0,2003.0,0.1,0,0,0,0,0,0,0,,0,0,0,0,0,0,0,0
ESP-La Liga,2425,Sevilla,Nemanja Gudelj,,,32.0,1991.0,27.7,42,24,16,22,4,21,35,60.0,14,27,10,17,27,69,94,1
ESP-La Liga,2425,Sevilla,Peque,,,21.0,2002.0,12.6,16,5,4,10,2,7,17,41.2,10,16,0,16,8,24,5,0
ESP-La Liga,2425,Sevilla,Ramón Martínez,,,21.0,2002.0,2.9,6,3,5,1,0,3,5,60.0,2,2,1,1,2,8,23,0
ESP-La Liga,2425,Sevilla,Ruben Vargas,,,25.0,1998.0,7.5,7,4,1,5,1,3,8,37.5,5,9,0,9,3,10,10,0
ESP-La Liga,2425,Sevilla,Saúl Ñíguez,,,29.0,1994.0,17.3,47,32,16,24,7,12,31,38.7,19,25,2,23,22,69,34,0
ESP-La Liga,2425,Sevilla,Stanis Idumbo,,,19.0,2005.0,3.2,9,5,3,4,2,3,5,60.0,2,3,1,2,4,13,2,0
ESP-La Liga,2425,Sevilla,Suso,,,30.0,1993.0,6.7,10,7,3,6,1,4,11,36.4,7,4,0,4,4,14,2,0
ESP-La Liga,2425,Sevilla,Tanguy Nianzou,,,22.0,2002.0,5.8,7,5,6,0,1,5,6,83.3,1,1,0,1,8,15,27,0
ESP-La Liga,2425,Sevilla,Valentín Barco,,,20.0,2004.0,3.2,15,9,8,3,4,12,15,80.0,3,0,0,0,2,17,5,0
ESP-La Liga,2425,Sevilla,Álvaro Fernández,,,26.0,1998.0,8.3,0,0,0,0,0,0,1,0.0,1,0,0,0,0,0,7,0
ESP-La Liga,2425,Sevilla,Álvaro Pascual,,,22.0,2002.0,4.5,5,3,0,3,2,1,5,20.0,4,4,0,4,2,7,9,0
ESP-La Liga,2425,Sevilla,Ørjan Nyland,,,33.0,1990.0,29.7,3,2,3,0,0,3,5,60.0,2,0,0,0,0,3,12,4
ESP-La Liga,2425,Valencia,Alberto Marí,,,23.0,2001.0,0.1,0,0,0,0,0,0,0,,0,0,0,0,0,0,0,0
ESP-La Liga,2425,Valencia,Cristhian Mosquera,,,20.0,2004.0,36.9,56,36,41,13,2,31,40,77.5,9,37,24,13,35,91,128,4
ESP-La Liga,2425,Valencia,César Tárrega,,,22.0,2002.0,33.6,49,37,33,13,3,19,31,61.3,12,41,20,21,22,71,222,2
ESP-La Liga,2425,Valencia,Dani Gómez,,,26.0,1998.0,5.9,3,2,0,0,3,0,0,,0,1,0,1,2,5,4,0
ESP-La Liga,2425,Valencia,David Otorbi,,,16.0,2007.0,0.2,0,0,0,0,0,0,0,,0,1,0,1,0,0,0,0
ESP-La Liga,2425,Valencia,Diego López,,,22.0,2002.0,30.4,31,18,11,16,4,16,47,34.0,31,30,0,30,16,47,15,0
ESP-La Liga,2425,Valencia,Dimitri Foulquier,,,31.0,1993.0,25.5,48,31,29,13,6,24,36,66.7,12,21,5,16,16,64,86,1
ESP-La Liga,2425,Valencia,Domingos André Ribeiro Almeida,,,24.0,2000.0,22.0,48,32,18,21,9,14,39,35.9,25,21,3,18,8,56,14,1
ESP-La Liga,2425,Valencia,Enzo Barrenechea,,,23.0,2001.0,24.3,57,30,22,29,6,32,46,69.6,14,30,8,22,28,85,48,1
ESP-La Liga,2425,Valencia,Francisco Perez,,,21.0,2002.0,6.3,17,12,7,8,2,10,16,62.5,6,8,1,7,3,20,6,0
ESP-La Liga,2425,Valencia,Germán Valera,,,22.0,2002.0,1.6,1,1,1,0,0,0,1,0.0,1,2,0,2,4,5,2,1
ESP-La Liga,2425,Valencia,Giorgi Mamardashvili,,,23.0,2000.0,34.0,2,2,2,0,0,2,3,66.7,1,0,0,0,1,3,16,3
ESP-La Liga,2425,Valencia,Hugo Duro,,,24.0,1999.0,24.1,13,8,4,7,2,5,13,38.5,8,11,2,9,10,23,11,0
ESP-La Liga,2425,Valencia,Hugo Guillamón,,,24.0,2000.0,4.0,11,8,1,9,1,9,10,90.0,1,4,1,3,5,16,9,1
ESP-La Liga,2425,Valencia,Iker Córdoba,,,18.0,2005.0,0.2,0,0,0,0,0,0,0,,0,0,0,0,0,0,1,0
ESP-La Liga,2425,Valencia,Ivan Jaime Pajuelo,,,23.0,2000.0,3.3,8,5,2,3,3,4,5,80.0,1,2,0,2,2,10,0,0
ESP-La Liga,2425,Valencia,Javier Guerra,,,21.0,2003.0,28.7,50,27,18,21,11,26,56,46.4,30,15,3,12,20,70,49,3
ESP-La Liga,2425,Valencia,Jesus Vazquez,,,21.0,2003.0,10.2,23,18,12,9,2,10,19,52.6,9,16,5,11,10,33,30,0
ESP-La Liga,2425,Valencia,José Luis García Vayá,,,25.0,1998.0,19.4,43,25,24,13,6,19,33,57.6,14,23,6,17,19,62,42,0
ESP-La Liga,2425,Valencia,José Luis Gayà,,,29.0,1995.0,20.0,57,40,39,15,3,40,58,69.0,18,16,2,14,25,82,61,0
ESP-La Liga,2425,Valencia,Luis Rioja,,,30.0,1993.0,31.5,33,21,14,12,7,14,42,33.3,28,30,1,29,22,55,44,1
ESP-La Liga,2425,Valencia,Martín Tejón,,,20.0,2004.0,0.5,2,0,0,2,0,1,2,50.0,1,0,0,0,0,2,0,0
ESP-La Liga,2425,Valencia,Max Aarons,,,24.0,2000.0,1.3,4,4,2,2,0,4,5,80.0,1,1,0,1,0,4,3,0
ESP-La Liga,2425,Valencia,Maximiliano Caufriez,,,27.0,1997.0,1.0,1,1,1,0,0,1,1,100.0,0,2,1,1,1,2,4,0
ESP-La Liga,2425,Valencia,Mouctar Diakhaby,,,27.0,1996.0,7.3,8,3,8,0,0,4,6,66.7,2,8,6,2,11,19,56,0
ESP-La Liga,2425,Valencia,Rafa Mir,,,27.0,1997.0,8.4,12,6,8,4,0,3,9,33.3,6,5,0,5,5,17,9,0
ESP-La Liga,2425,Valencia,Rodrigo Abajas,,,21.0,2003.0,0.7,3,2,2,1,0,3,3,100.0,0,1,0,1,1,4,0,0
ESP-La Liga,2425,Valencia,Sergi Canós,,,27.0,1997.0,4.1,11,7,3,4,4,4,10,40.0,6,6,1,5,5,16,5,0
ESP-La Liga,2425,Valencia,Stole Dimitrievski,,,30.0,1993.0,4.0,0,0,0,0,0,0,0,,0,0,0,0,0,0,3,1
ESP-La Liga,2425,Valencia,Thierry Correia,,,25.0,1999.0,8.5,27,18,19,5,3,13,23,56.5,10,10,1,9,4,31,18,0
ESP-La Liga,2425,Valencia,Umar Sadiq,,,27.0,1997.0,9.2,10,5,3,5,2,4,6,66.7,2,7,0,7,1,11,7,0
ESP-La Liga,2425,Valencia,Yarek Gasiorowski,,,19.0,2005.0,10.5,19,16,16,3,0,9,13,69.2,4,17,6,11,26,45,60,0
ESP-La Liga,2425,Valladolid,Adam Aznou,,,18.0,2006.0,9.7,28,21,20,8,0,21,43,48.8,22,24,8,16,10,38,30,0
ESP-La Liga,2425,Valladolid,Adrian Baquerin,,,17.0,2007.0,0.5,1,1,0,1,0,0,0,,0,0,0,0,0,1,1,0
ESP-La Liga,2425,Valladolid,Amath,,,28.0,1996.0,4.2,2,0,2,0,0,1,8,12.5,7,7,1,6,2,4,6,0
ESP-La Liga,2425,Valladolid,André Ferreira,,,28.0,1996.0,6.0,0,0,0,0,0,0,0,,0,0,0,0,0,0,4,2
ESP-La Liga,2425,Valladolid,Antonio Candela,,,24.0,2000.0,10.1,9,6,6,2,1,4,11,36.4,7,11,6,5,6,15,33,0
ESP-La Liga,2425,Valladolid,Anuar,,,29.0,1995.0,19.1,38,27,21,12,5,15,28,53.6,13,24,8,16,18,56,26,1
ESP-La Liga,2425,Valladolid,Arnau Rafús,,,21.0,2003.0,1.0,0,0,0,0,0,0,0,,0,0,0,0,0,0,0,1
ESP-La Liga,2425,Valladolid,Cenk Özkacar,,,23.0,2000.0,8.4,9,5,7,2,0,4,14,28.6,10,9,6,3,18,27,69,1
ESP-La Liga,2425,Valladolid,Chuky san jose,,,20.0,2004.0,8.1,8,2,3,3,2,2,9,22.2,7,4,1,3,0,8,4,0
ESP-La Liga,2425,Valladolid,Darwin Machís,,,31.0,1993.0,7.1,5,4,3,2,0,3,9,33.3,6,3,0,3,5,10,13,0
ESP-La Liga,2425,Valladolid,David Torres,,,21.0,2003.0,15.4,13,8,12,1,0,7,11,63.6,4,19,17,2,10,23,74,0
ESP-La Liga,2425,Valladolid,Enzo Boyomo,,,22.0,2001.0,3.0,6,2,4,2,0,3,3,100.0,0,4,3,1,1,7,7,0
ESP-La Liga,2425,Valladolid,Eray Cömert,,,26.0,1998.0,19.8,24,14,15,9,0,12,21,57.1,9,28,15,13,24,48,75,2
ESP-La Liga,2425,Valladolid,Florian Grillitsch,,,28.0,1995.0,6.9,11,7,7,3,1,7,15,46.7,8,12,2,10,4,15,5,1
ESP-La Liga,2425,Valladolid,Henrique,,,30.0,1994.0,3.9,6,2,3,2,1,1,4,25.0,3,5,0,5,3,9,12,0
ESP-La Liga,2425,Valladolid,Iago Parente,,,18.0,2006.0,0.8,0,0,0,0,0,0,0,,0,0,0,0,0,0,2,0
ESP-La Liga,2425,Valladolid,Ibrahim Alani,,,18.0,2006.0,1.8,12,7,8,4,0,4,6,66.7,2,3,1,2,1,13,1,0
ESP-La Liga,2425,Valladolid,Iván Sánchez,,,31.0,1992.0,15.6,37,20,18,10,9,12,27,44.4,15,18,3,15,14,51,10,0
ESP-La Liga,2425,Valladolid,Javi Sánchez,,,27.0,1997.0,22.5,26,16,19,6,1,17,26,65.4,9,39,28,11,22,48,111,3
ESP-La Liga,2425,Valladolid,Joseph Aidoo,,,28.0,1995.0,6.5,5,5,3,2,0,2,3,66.7,1,8,4,4,5,10,26,1
ESP-La Liga,2425,Valladolid,Juanmi Latasa,,,23.0,2001.0,15.5,4,2,1,1,2,2,6,33.3,4,4,1,3,0,4,11,1
ESP-La Liga,2425,Valladolid,Juma Bah,,,18.0,2006.0,9.6,10,7,7,3,0,3,5,60.0,2,15,8,7,12,22,60,0
ESP-La Liga,2425,Valladolid,Karl Jakob Hein,,,22.0,2002.0,31.0,0,0,0,0,0,0,2,0.0,2,0,0,0,0,0,19,2
ESP-La Liga,2425,Valladolid,Kenedy,,,28.0,1996.0,0.1,0,0,0,0,0,0,0,,0,1,0,1,0,0,0,0
ESP-La Liga,2425,Valladolid,Kike Pérez,,,27.0,1997.0,13.2,37,26,15,19,3,15,26,57.7,11,16,4,12,7,44,18,0
ESP-La Liga,2425,Valladolid,Lucas Oliveira Rosa,,,24.0,2000.0,21.0,53,33,40,11,2,35,51,68.6,16,24,9,15,28,81,69,2
ESP-La Liga,2425,Valladolid,Luis Pérez,,,29.0,1995.0,28.4,41,30,25,11,5,24,40,60.0,16,26,9,17,29,70,86,0
ESP-La Liga,2425,Valladolid,Mamadou Sylla,,,30.0,1994.0,17.6,8,4,3,3,2,2,9,22.2,7,8,0,8,3,11,14,1
ESP-La Liga,2425,Valladolid,Marcos André,,,27.0,1996.0,13.2,10,6,3,5,2,5,13,38.5,8,18,2,16,3,13,10,0
ESP-La Liga,2425,Valladolid,Mario Maroto,,,20.0,2003.0,0.7,0,0,0,0,0,0,2,0.0,2,0,0,0,2,2,2,0
ESP-La Liga,2425,Valladolid,Mario Martín,,,20.0,2004.0,19.4,62,32,31,27,4,21,49,42.9,28,32,7,25,21,83,46,7
ESP-La Liga,2425,Valladolid,Raúl Chasco,,,20.0,2003.0,1.4,4,1,3,1,0,2,4,50.0,2,1,0,1,2,6,2,0
ESP-La Liga,2425,Valladolid,Raúl Moro,,,21.0,2002.0,26.0,22,13,15,4,3,13,32,40.6,19,8,0,8,10,32,20,1
ESP-La Liga,2425,Valladolid,Selim Amallah,,,27.0,1996.0,15.3,30,18,10,18,2,10,18,55.6,8,24,2,22,14,44,5,1
ESP-La Liga,2425,Valladolid,Stanko Jurić,,,27.0,1996.0,19.2,48,24,26,19,3,19,48,39.6,29,35,11,24,24,72,52,0
ESP-La Liga,2425,Valladolid,Tamás Nikitscher,,,24.0,1999.0,9.5,17,8,8,9,0,8,13,61.5,5,17,4,13,11,28,16,1
ESP-La Liga,2425,Valladolid,Víctor Meseguer,,,25.0,1999.0,4.6,10,6,4,4,2,2,10,20.0,8,3,0,3,2,12,4,1
ESP-La Liga,2425,Valladolid,Xavier Moreno,,,19.0,2004.0,0.5,0,0,0,0,0,0,0,,0,0,0,0,0,0,1,0
ESP-La Liga,2425,Villarreal,Alex Baena,,,23.0,2001.0,28.8,28,15,6,14,8,10,39,25.6,29,29,2,27,22,50,22,2
ESP-La Liga,2425,Villarreal,Alfonso Pedraza,,,28.0,1996.0,5.1,3,2,2,0,1,2,4,50.0,2,3,1,2,6,9,16,0
ESP-La Liga,2425,Villarreal,Arnau Solà,,,21.0,2003.0,0.1,0,0,0,0,0,0,2,0.0,2,1,1,0,0,0,0,0
ESP-La Liga,2425,Villarreal,Arnaut Danjuma,,,27.0,1997.0,2.2,2,1,0,1,1,0,1,0.0,1,1,0,1,0,2,0,0
ESP-La Liga,2425,Villarreal,Ayoze Pérez,,,31.0,1993.0,21.9,27,14,5,18,4,6,24,25.0,18,17,0,17,8,35,15,0
ESP-La Liga,2425,Villarreal,Daniel Parejo,,,35.0,1989.0,25.3,52,40,27,20,5,29,54,53.7,25,24,7,17,24,76,40,1
ESP-La Liga,2425,Villarreal,Daniel Requena,,,20.0,2004.0,0.1,0,0,0,0,0,0,0,,0,0,0,0,0,0,0,0
ESP-La Liga,2425,Villarreal,Denis Suárez,,,30.0,1994.0,6.8,12,8,7,2,3,4,10,40.0,6,4,1,3,3,15,3,0
ESP-La Liga,2425,Villarreal,Diego Conde,,,25.0,1998.0,21.8,2,2,2,0,0,2,4,50.0,2,0,0,0,1,3,9,2
ESP-La Liga,2425,Villarreal,Eric Bailly,,,30.0,1994.0,6.9,12,4,6,6,0,3,4,75.0,1,12,6,6,6,18,29,0
ESP-La Liga,2425,Villarreal,Gerard Moreno,,,32.0,1992.0,8.0,7,4,3,2,2,3,12,25.0,9,0,0,0,2,9,8,0
ESP-La Liga,2425,Villarreal,Ilias Akhomach,,,20.0,2004.0,6.5,12,7,4,4,4,6,12,50.0,6,8,0,8,3,15,13,0
ESP-La Liga,2425,Villarreal,Juan Bernat,,,31.0,1993.0,2.4,9,7,7,1,1,4,5,80.0,1,3,1,2,1,10,4,0
ESP-La Liga,2425,Villarreal,Juan Foyth,,,26.0,1998.0,16.9,25,15,15,6,4,11,16,68.8,5,26,17,9,19,44,119,3
ESP-La Liga,2425,Villarreal,Karl Etta,,,20.0,2003.0,0.4,0,0,0,0,0,0,1,0.0,1,1,0,1,0,0,0,0
ESP-La Liga,2425,Villarreal,Kiko Femenía,,,33.0,1991.0,24.7,50,34,34,14,2,33,57,57.9,24,21,10,11,40,90,62,3
ESP-La Liga,2425,Villarreal,Logan Costa,,,23.0,2001.0,28.7,38,21,25,12,1,24,29,82.8,5,25,14,11,21,59,115,2
ESP-La Liga,2425,Villarreal,Luiz Lúcio Reis Júnior,,,23.0,2001.0,16.2,0,0,0,0,0,0,0,,0,0,0,0,0,0,14,1
ESP-La Liga,2425,Villarreal,Nicolas Pépé,,,29.0,1995.0,16.7,22,9,12,6,4,6,17,35.3,11,12,1,11,5,27,12,0
ESP-La Liga,2425,Villarreal,Pape Gueye,,,25.0,1999.0,24.7,54,26,23,23,8,20,29,69.0,9,31,13,18,27,81,53,2
ESP-La Liga,2425,Villarreal,Pau Cabanes,,,19.0,2005.0,1.8,4,4,0,3,1,3,4,75.0,1,5,0,5,3,7,2,1
ESP-La Liga,2425,Villarreal,Pau Navarro,,,19.0,2005.0,10.2,23,17,15,6,2,19,39,48.7,20,13,6,7,4,27,41,0
ESP-La Liga,2425,Villarreal,Ramón Terrats,,,23.0,2000.0,1.5,3,3,1,2,0,2,4,50.0,2,3,1,2,2,5,3,0
ESP-La Liga,2425,Villarreal,Raúl Albiol,,,38.0,1985.0,13.2,10,9,9,1,0,6,10,60.0,4,10,9,1,6,16,69,1
ESP-La Liga,2425,Villarreal,Santi Comesaña,,,27.0,1996.0,28.4,85,49,44,32,9,42,76,55.3,34,56,22,34,19,104,56,1
ESP-La Liga,2425,Villarreal,Sergi Cardona,,,25.0,1999.0,32.7,71,48,44,20,7,49,79,62.0,30,52,7,45,40,111,122,1
ESP-La Liga,2425,Villarreal,Tajon Buchanan,,,25.0,1999.0,4.6,10,5,6,4,0,6,9,66.7,3,6,0,6,1,11,1,0
ESP-La Liga,2425,Villarreal,Thiago Ojeda,,,21.0,2003.0,0.1,0,0,0,0,0,0,0,,0,0,0,0,0,0,1,0
ESP-La Liga,2425,Villarreal,Thierno Barry,,,21.0,2002.0,25.8,11,8,2,5,4,4,10,40.0,6,15,2,13,0,11,19,0
ESP-La Liga,2425,Villarreal,Willy Kambwala,,,19.0,2004.0,12.4,17,12,14,2,1,10,12,83.3,2,10,7,3,10,27,56,1
ESP-La Liga,2425,Villarreal,Yeremi Pino,,,21.0,2002.0,21.5,60,32,20,32,8,32,65,49.2,33,38,3,35,8,68,18,0
FRA-Ligue 1,2425,Angers,Abdoulaye Bamba,,,34.0,1990.0,16.8,22,12,17,4,1,14,19,73.7,5,14,8,6,19,41,79,0
FRA-Ligue 1,2425,Angers,Bamba Dieng,,,24.0,2000.0,5.9,4,1,1,2,1,0,2,0.0,2,2,0,2,0,4,3,0
FRA-Ligue 1,2425,Angers,Carlens Arcus,,,28.0,1996.0,22.7,52,35,32,15,5,34,56,60.7,22,24,4,20,27,79,83,3
FRA-Ligue 1,2425,Angers,Cédric Hountondji,,,30.0,1994.0,3.0,6,4,4,2,0,3,7,42.9,4,3,3,0,4,10,14,0
FRA-Ligue 1,2425,Angers,Emmanuel Biumla,,,19.0,2005.0,14.8,19,12,14,5,0,12,18,66.7,6,18,8,10,8,27,84,1
FRA-Ligue 1,2425,Angers,Enzo Caumont,,,20.0,2004.0,0.4,1,1,0,1,0,1,2,50.0,1,1,1,0,1,2,1,0
FRA-Ligue 1,2425,Angers,Esteban Lepaul,,,24.0,2000.0,18.1,11,6,2,6,3,4,16,25.0,12,15,2,13,4,15,10,0
FRA-Ligue 1,2425,Angers,Farid El Melali,,,27.0,1997.0,21.0,28,16,15,6,7,13,35,37.1,22,19,1,18,16,44,12,1
FRA-Ligue 1,2425,Angers,Florent Hanin,,,34.0,1990.0,29.7,69,48,45,17,7,39,71,54.9,32,31,10,21,47,116,99,2
FRA-Ligue 1,2425,Angers,Haris Belkebla,,,30.0,1994.0,19.9,56,38,38,15,3,26,45,57.8,19,30,9,21,35,91,46,1
FRA-Ligue 1,2425,Angers,Himad Abdelli,,,24.0,1999.0,31.6,48,32,13,20,15,15,48,31.3,33,24,1,23,26,74,28,2
FRA-Ligue 1,2425,Angers,Ibrahima Niane,,,25.0,1999.0,10.5,7,3,3,2,2,3,3,100.0,0,6,1,5,2,9,6,2
FRA-Ligue 1,2425,Angers,Jacques Ekomie,,,20.0,2003.0,7.7,22,14,9,10,3,8,12,66.7,4,16,5,11,4,26,14,0
FRA-Ligue 1,2425,Angers,Jean-Eudes Aholou,,,30.0,1994.0,21.8,56,36,26,20,10,22,48,45.8,26,34,14,20,33,89,32,0
FRA-Ligue 1,2425,Angers,Jim Allevinah,,,29.0,1995.0,19.4,19,11,6,9,4,5,28,17.9,23,10,0,10,12,31,17,0
FRA-Ligue 1,2425,Angers,Jordan Lefort,,,30.0,1993.0,34.0,52,30,42,9,1,30,44,68.2,14,56,37,19,32,84,206,3
FRA-Ligue 1,2425,Angers,Justin-Noël Kalumba,,,19.0,2004.0,0.3,0,0,0,0,0,0,0,,0,0,0,0,1,1,1,0
FRA-Ligue 1,2425,Angers,Lanroy Machine,,,18.0,2005.0,0.1,0,0,0,0,0,0,0,,0,0,0,0,0,0,0,0
FRA-Ligue 1,2425,Angers,Lilian Raolisoa,,,24.0,2000.0,14.6,41,24,24,13,4,17,38,44.7,21,11,2,9,15,56,45,0
FRA-Ligue 1,2425,Angers,Lois Diony,,,31.0,1992.0,0.2,0,0,0,0,0,0,0,,0,0,0,0,0,0,0,0
FRA-Ligue 1,2425,Angers,Marius Courcoul,,,17.0,2007.0,3.4,5,2,3,2,0,2,5,40.0,3,4,0,4,5,10,9,0
FRA-Ligue 1,2425,Angers,Melvin Zinga,,,22.0,2002.0,1.0,0,0,0,0,0,0,0,,0,0,0,0,0,0,1,0
FRA-Ligue 1,2425,Angers,Ousmane Camara,,,21.0,2003.0,2.8,4,3,3,1,0,1,2,50.0,1,1,1,0,0,4,18,0
FRA-Ligue 1,2425,Angers,Pierrick Capelle,,,37.0,1987.0,5.4,24,17,10,9,5,9,18,50.0,9,4,1,3,11,35,5,1
FRA-Ligue 1,2425,Angers,Prosper Peter,,,16.0,2007.0,0.3,2,1,0,2,0,0,0,,0,0,0,0,0,2,0,0
FRA-Ligue 1,2425,Angers,Sidiki Cherif,,,17.0,2006.0,3.6,5,5,1,3,1,3,4,75.0,1,4,1,3,0,5,0,1
FRA-Ligue 1,2425,Angers,Yahia Fofana,,,23.0,2000.0,33.0,0,0,0,0,0,0,2,0.0,2,0,0,0,1,1,25,2
FRA-Ligue 1,2425,Angers,Yassin Belkhdim,,,22.0,2002.0,16.9,53,27,26,21,6,27,58,46.6,31,23,6,17,21,74,41,1
FRA-Ligue 1,2425,Angers,Zinedine Ferhat,,,31.0,1993.0,9.4,9,7,1,5,3,4,13,30.8,9,9,0,9,10,19,12,0
FRA-Ligue 1,2425,Angers,Zinédine Ould Khaled,,,24.0,2000.0,3.8,9,7,5,3,1,2,13,15.4,11,6,1,5,2,11,12,0
FRA-Ligue 1,2425,Auxerre,Ado Onaiwu,,,28.0,1995.0,10.6,11,7,2,6,3,4,14,28.6,10,12,0,12,3,14,12,0
FRA-Ligue 1,2425,Auxerre,Aristide Zossou,,,19.0,2005.0,0.2,0,0,0,0,0,0,0,,0,0,0,0,0,0,0,0
FRA-Ligue 1,2425,Auxerre,Assane Dioussé,,,26.0,1997.0,7.4,15,7,9,5,1,5,14,35.7,9,6,2,4,12,27,15,0
FRA-Ligue 1,2425,Auxerre,Ben Viadere,,,18.0,2005.0,0.1,0,0,0,0,0,0,0,,0,0,0,0,0,0,0,0
FRA-Ligue 1,2425,Auxerre,Clément Akpa,,,22.0,2001.0,27.6,55,34,36,12,7,31,46,67.4,15,38,14,24,42,97,141,2
FRA-Ligue 1,2425,Auxerre,Donovan Léon,,,31.0,1992.0,32.0,0,0,0,0,0,0,3,0.0,3,2,0,2,0,0,26,1
FRA-Ligue 1,2425,Auxerre,Elisha Owusu,,,26.0,1997.0,26.0,73,41,29,39,5,31,48,64.6,17,33,9,24,42,115,35,1
FRA-Ligue 1,2425,Auxerre,Eros Maddy,,,23.0,2001.0,0.2,0,0,0,0,0,0,0,,0,0,0,0,0,0,0,0
FRA-Ligue 1,2425,Auxerre,Florian Ayé,,,27.0,1997.0,6.4,2,2,0,0,2,0,2,0.0,2,7,0,7,7,9,6,0
FRA-Ligue 1,2425,Auxerre,Fredrik Oppegard,,,21.0,2002.0,3.0,6,4,4,1,1,3,7,42.9,4,2,1,1,2,8,12,1
FRA-Ligue 1,2425,Auxerre,Gabriel Osho,,,25.0,1998.0,18.4,23,15,17,3,3,13,20,65.0,7,32,19,13,12,35,87,0
FRA-Ligue 1,2425,Auxerre,Gaëtan Perrin,,,28.0,1996.0,29.9,49,26,22,12,15,21,48,43.8,27,10,0,10,12,61,4,1
FRA-Ligue 1,2425,Auxerre,Gideon Mensah,,,26.0,1998.0,25.3,68,45,37,21,10,33,66,50.0,33,27,4,23,50,118,83,0
FRA-Ligue 1,2425,Auxerre,Hamed Junior Traorè,,,24.0,2000.0,23.3,41,20,11,17,13,16,54,29.6,38,14,0,14,8,49,11,0
FRA-Ligue 1,2425,Auxerre,Han-Noah Massengo,,,23.0,2001.0,11.6,17,11,5,8,4,8,12,66.7,4,12,4,8,17,34,10,2
FRA-Ligue 1,2425,Auxerre,Jubal,,,30.0,1993.0,29.3,60,39,46,13,1,28,40,70.0,12,61,36,25,25,85,201,1
FRA-Ligue 1,2425,Auxerre,Ki-Jana Hoever,,,22.0,2002.0,23.6,51,38,26,16,9,30,54,55.6,24,33,3,30,21,72,70,1
FRA-Ligue 1,2425,Auxerre,Kévin Danois,,,20.0,2004.0,16.2,49,30,20,22,7,20,46,43.5,26,17,3,14,20,69,20,0
FRA-Ligue 1,2425,Auxerre,Lassine Sinayoko,,,24.0,1999.0,25.5,33,20,10,14,9,11,23,47.8,12,16,2,14,13,46,38,0
FRA-Ligue 1,2425,Auxerre,Lasso Coulibaly,,,21.0,2002.0,0.5,1,1,0,0,1,0,0,,0,0,0,0,0,1,0,0
FRA-Ligue 1,2425,Auxerre,Loïc N'Gatta,,,20.0,2003.0,0.1,1,1,0,1,0,1,2,50.0,1,1,0,1,0,1,1,0
FRA-Ligue 1,2425,Auxerre,Paul Joly,,,24.0,2000.0,11.2,49,32,30,17,2,27,45,60.0,18,19,1,18,25,74,32,5
FRA-Ligue 1,2425,Auxerre,Rayan Raveloson,,,27.0,1997.0,8.0,6,5,2,4,0,5,15,33.3,10,8,7,1,5,11,22,0
FRA-Ligue 1,2425,Auxerre,Rudy Matondo,,,16.0,2008.0,0.7,1,1,1,0,0,0,1,0.0,1,0,0,0,0,1,2,0
FRA-Ligue 1,2425,Auxerre,Sinaly Diomande,,,23.0,2001.0,21.6,39,19,20,18,1,28,40,70.0,12,37,18,19,30,69,100,2
FRA-Ligue 1,2425,Auxerre,Theo Bair,,,24.0,1999.0,10.4,4,3,1,2,1,0,2,0.0,2,6,2,4,3,7,10,0
FRA-Ligue 1,2425,Auxerre,Théo De Percin,,,23.0,2001.0,2.0,0,0,0,0,0,0,1,0.0,1,0,0,0,0,0,3,0
FRA-Ligue 1,2425,Auxerre,Théo Pellenard,,,30.0,1994.0,0.5,3,2,2,1,0,1,3,33.3,2,1,0,1,0,3,3,0
FRA-Ligue 1,2425,Auxerre,Yoann Cissé,,,19.0,2004.0,0.1,0,0,0,0,0,0,0,,0,0,0,0,1,1,0,0
FRA-Ligue 1,2425,Brest,Abdallah Sima,,,23.0,2001.0,13.8,15,11,2,5,8,4,11,36.4,7,9,1,8,1,16,9,0
FRA-Ligue 1,2425,Brest,Abdoulaye Niakhate Ndiaye,,,22.0,2002.0,19.0,49,33,36,12,1,25,37,67.6,12,29,17,12,11,60,144,3
FRA-Ligue 1,2425,Brest,Axel Camblan,,,20.0,2003.0,0.3,1,1,0,0,1,1,2,50.0,1,1,0,1,0,1,0,0
FRA-Ligue 1,2425,Brest,Bradley Locko,,,22.0,2002.0,1.1,2,2,1,1,0,1,1,100.0,0,3,2,1,1,3,3,0
FRA-Ligue 1,2425,Brest,Brendan Chardonnet,,,29.0,1994.0,26.8,45,33,28,14,3,25,40,62.5,15,45,28,17,29,74,169,2
FRA-Ligue 1,2425,Brest,Edimilson Fernandes,,,28.0,1996.0,12.3,9,7,3,6,0,7,13,53.8,6,14,6,8,20,29,38,1
FRA-Ligue 1,2425,Brest,Grégoire Coudert,,,25.0,1999.0,2.0,0,0,0,0,0,0,0,,0,0,0,0,0,0,1,0
FRA-Ligue 1,2425,Brest,Hamidou Makalou,,,18.0,2006.0,0.4,0,0,0,0,0,0,0,,0,0,0,0,0,0,0,0
FRA-Ligue 1,2425,Brest,Hianga Mananga Mbock,,,24.0,1999.0,0.2,0,0,0,0,0,0,0,,0,0,0,0,1,1,0,0
FRA-Ligue 1,2425,Brest,Hugo Magnetti,,,26.0,1998.0,25.8,52,32,21,27,4,23,51,45.1,28,20,3,17,18,70,37,0
FRA-Ligue 1,2425,Brest,Ibrahim Salah,,,22.0,2001.0,4.0,4,2,1,1,2,1,6,16.7,5,2,0,2,2,6,0,0
FRA-Ligue 1,2425,Brest,Jonas Martin,,,34.0,1990.0,5.5,13,7,10,2,1,6,11,54.5,5,4,1,3,8,21,12,1
FRA-Ligue 1,2425,Brest,Jordan Amavi,,,30.0,1994.0,8.8,24,17,10,11,3,15,21,71.4,6,10,2,8,7,31,18,0
FRA-Ligue 1,2425,Brest,Julien Le Cardinal,,,26.0,1997.0,15.3,27,15,16,8,3,11,16,68.8,5,18,14,4,33,60,75,0
FRA-Ligue 1,2425,Brest,Justin Bourgault,,,18.0,2005.0,1.4,2,1,1,1,0,0,0,,0,0,0,0,0,2,1,0
FRA-Ligue 1,2425,Brest,Jérémy Le Douaron,,,26.0,1998.0,1.1,1,0,0,0,1,0,1,0.0,1,1,0,1,0,1,0,0
FRA-Ligue 1,2425,Brest,Kamory Doumbia,,,21.0,2003.0,14.7,41,29,17,17,7,14,31,45.2,17,17,1,16,28,69,13,1
FRA-Ligue 1,2425,Brest,Kenny Lala,,,32.0,1991.0,29.8,66,42,36,23,7,38,57,66.7,19,25,9,16,25,91,75,2
FRA-Ligue 1,2425,Brest,Luck Zogbé,,,19.0,2005.0,7.1,32,18,17,11,4,18,26,69.2,8,11,2,9,14,46,22,1
FRA-Ligue 1,2425,Brest,Ludovic Ajorque,,,30.0,1994.0,27.7,26,19,3,12,11,10,32,31.3,22,20,5,15,6,32,26,0
FRA-Ligue 1,2425,Brest,Mahdi Camara,,,26.0,1998.0,29.5,71,40,16,38,17,24,46,52.2,22,40,5,35,33,104,29,0
FRA-Ligue 1,2425,Brest,Mama Samba Baldé,,,28.0,1995.0,12.8,13,9,4,4,5,3,14,21.4,11,8,0,8,6,19,14,0
FRA-Ligue 1,2425,Brest,Marco Bizot,,,33.0,1991.0,32.0,2,1,2,0,0,1,2,50.0,1,0,0,0,0,2,33,0
FRA-Ligue 1,2425,Brest,Massadio Haïdara,,,31.0,1992.0,18.6,27,16,16,9,2,13,29,44.8,16,18,2,16,26,53,73,0
FRA-Ligue 1,2425,Brest,Mathias Pereira Lage,,,27.0,1996.0,17.5,37,24,16,13,8,18,39,46.2,21,17,2,15,20,57,20,2
FRA-Ligue 1,2425,Brest,Pierre Lees-Melou,,,31.0,1993.0,17.0,48,33,20,19,9,25,54,46.3,29,19,3,16,12,60,23,0
FRA-Ligue 1,2425,Brest,Romain Del Castillo,,,28.0,1996.0,14.0,31,22,9,13,9,19,32,59.4,13,16,0,16,6,37,5,0
FRA-Ligue 1,2425,Brest,Romain Faivre,,,26.0,1998.0,10.0,13,10,4,5,4,5,10,50.0,5,8,0,8,4,17,3,1
FRA-Ligue 1,2425,Brest,Soumaïla Coulibaly,,,20.0,2003.0,4.9,4,2,2,2,0,1,1,100.0,0,7,2,5,5,9,26,0
FRA-Ligue 1,2425,Brest,Sérigné Diop,,,19.0,2005.0,0.0,1,0,0,1,0,0,0,,0,1,0,1,0,1,0,0
FRA-Ligue 1,2425,Le Havre,Abdoulaye Touré,,,30.0,1994.0,25.8,61,34,31,21,9,33,59,55.9,26,36,19,17,34,95,42,5
FRA-Ligue 1,2425,Le Havre,Alois Confais,,,27.0,1996.0,0.0,0,0,0,0,0,0,0,,0,0,0,0,0,0,0,0
FRA-Ligue 1,2425,Le Havre,André Ayew,,,34.0,1989.0,16.1,18,10,3,7,8,7,13,53.8,6,9,2,7,3,21,21,1
FRA-Ligue 1,2425,Le Havre,Antoine Joujou,,,21.0,2003.0,10.5,16,11,10,4,2,9,15,60.0,6,15,3,12,9,25,19,0
FRA-Ligue 1,2425,Le Havre,Arouna Sangante,,,22.0,2002.0,13.8,25,16,11,14,0,10,17,58.8,7,11,5,6,21,46,65,3
FRA-Ligue 1,2425,Le Havre,Arthur Desmas,,,30.0,1994.0,18.0,0,0,0,0,0,0,1,0.0,1,0,0,0,0,0,9,1
FRA-Ligue 1,2425,Le Havre,Christopher Operi,,,27.0,1997.0,13.0,13,9,6,2,5,7,12,58.3,5,20,6,14,14,27,30,0
FRA-Ligue 1,2425,Le Havre,Daler Kuzyaev,,,31.0,1993.0,6.3,13,8,7,4,2,2,9,22.2,7,7,4,3,9,22,8,0
FRA-Ligue 1,2425,Le Havre,Elysée Logbo,,,20.0,2004.0,0.3,0,0,0,0,0,0,0,,0,0,0,0,0,0,0,0
FRA-Ligue 1,2425,Le Havre,Emmanuel Sabbi,,,26.0,1997.0,7.3,14,7,7,4,3,5,8,62.5,3,2,0,2,3,17,4,0
FRA-Ligue 1,2425,Le Havre,Etienne Youte Kinkoue,,,22.0,2002.0,25.8,19,10,11,7,1,13,20,65.0,7,36,23,13,29,48,158,3
FRA-Ligue 1,2425,Le Havre,Fodé Ballo-Touré,,,27.0,1997.0,6.5,8,7,3,4,1,5,9,55.6,4,8,3,5,4,12,27,0
FRA-Ligue 1,2425,Le Havre,Gautier Lloris,,,29.0,1995.0,30.8,68,43,52,16,0,38,53,71.7,15,33,21,12,34,102,192,0
FRA-Ligue 1,2425,Le Havre,Ilyes Housni,,,19.0,2005.0,2.6,7,5,2,3,2,2,4,50.0,2,2,0,2,1,8,2,0
FRA-Ligue 1,2425,Le Havre,Issa Soumaré,,,23.0,2000.0,21.1,25,14,8,10,7,13,49,26.5,36,19,4,15,16,41,32,0
FRA-Ligue 1,2425,Le Havre,Josué Casimir,,,22.0,2001.0,22.2,37,26,15,15,7,9,18,50.0,9,19,0,19,7,44,35,1
FRA-Ligue 1,2425,Le Havre,Junior Mwanga,,,21.0,2003.0,10.6,26,16,10,13,3,11,19,57.9,8,10,3,7,8,34,18,2
FRA-Ligue 1,2425,Le Havre,Kandet Diawara,,,24.0,2000.0,0.0,0,0,0,0,0,0,0,,0,1,0,1,0,0,1,0
FRA-Ligue 1,2425,Le Havre,Koka,,,31.0,1993.0,9.5,4,1,1,3,0,0,4,0.0,4,3,0,3,4,8,6,1
FRA-Ligue 1,2425,Le Havre,Loïc Nego,,,33.0,1991.0,27.3,58,35,37,16,5,41,64,64.1,23,17,3,14,29,87,82,0
FRA-Ligue 1,2425,Le Havre,Mahamadou Diawara,,,19.0,2005.0,6.5,20,12,10,8,2,8,13,61.5,5,13,6,7,13,33,11,1
FRA-Ligue 1,2425,Le Havre,Mathieu Gorgelin,,,33.0,1990.0,16.0,2,2,2,0,0,2,3,66.7,1,0,0,0,0,2,8,2
FRA-Ligue 1,2425,Le Havre,Mathéo Bodmer,,,20.0,2004.0,0.1,0,0,0,0,0,0,0,,0,0,0,0,0,0,1,0
FRA-Ligue 1,2425,Le Havre,Oussama Targhalline,,,22.0,2002.0,11.0,19,14,12,3,4,5,12,41.7,7,14,7,7,19,38,14,2
FRA-Ligue 1,2425,Le Havre,Rassoul Ndiaye,,,22.0,2001.0,11.8,35,25,19,12,4,11,25,44.0,14,15,4,11,12,47,24,0
FRA-Ligue 1,2425,Le Havre,Samuel Grandsir,,,27.0,1996.0,0.9,5,5,0,3,2,2,3,66.7,1,2,0,2,0,5,0,0
FRA-Ligue 1,2425,Le Havre,Steve Ngoura,,,19.0,2005.0,3.2,4,2,1,1,2,3,3,100.0,0,2,1,1,0,4,2,0
FRA-Ligue 1,2425,Le Havre,Timothee Pembele,,,21.0,2002.0,12.4,30,22,17,9,4,14,23,60.9,9,16,5,11,11,41,42,0
FRA-Ligue 1,2425,Le Havre,Yanis Zouaoui,,,30.0,1994.0,10.8,20,10,10,8,2,11,15,73.3,4,15,2,13,8,28,43,0
FRA-Ligue 1,2425,Le Havre,Yassine Kechta,,,22.0,2002.0,23.3,60,36,32,21,7,33,78,42.3,45,25,2,23,26,86,32,2
FRA-Ligue 1,2425,Le Havre,Yoann Salmier,,,31.0,1992.0,8.9,14,7,9,4,1,10,13,76.9,3,12,8,4,10,24,59,0
FRA-Ligue 1,2425,Lens,Abdukodir Khusanov,,,20.0,2004.0,10.8,15,11,9,5,1,7,11,63.6,4,17,11,6,26,41,57,0
FRA-Ligue 1,2425,Lens,Adrien Thomasson,,,30.0,1993.0,29.1,90,47,42,25,23,52,95,54.7,43,48,3,45,19,109,28,2
FRA-Ligue 1,2425,Lens,Anass Zaroury,,,23.0,2000.0,15.6,23,17,6,12,5,9,26,34.6,17,9,0,9,6,29,15,0
FRA-Ligue 1,2425,Lens,Andy Diouf,,,21.0,2003.0,24.7,37,26,10,22,5,16,40,40.0,24,24,1,23,15,52,18,2
FRA-Ligue 1,2425,Lens,Angelo Fulgini,,,27.0,1996.0,11.6,14,10,6,4,4,6,16,37.5,10,11,1,10,2,16,3,0
FRA-Ligue 1,2425,Lens,Brice Samba,,,30.0,1994.0,15.0,0,0,0,0,0,0,0,,0,0,0,0,1,1,6,2
FRA-Ligue 1,2425,Lens,David Costa,,,23.0,2001.0,3.9,2,0,1,1,0,1,4,25.0,3,5,1,4,1,3,0,0
FRA-Ligue 1,2425,Lens,Deiver Machado,,,30.0,1993.0,20.1,36,26,14,14,8,17,30,56.7,13,20,4,16,16,52,34,2
FRA-Ligue 1,2425,Lens,Facundo Medina,,,25.0,1999.0,28.3,44,29,22,18,4,24,42,57.1,18,30,10,20,32,76,70,0
FRA-Ligue 1,2425,Lens,Florian Sotoca,,,33.0,1990.0,19.9,22,13,3,8,11,12,22,54.5,10,12,2,10,14,36,25,0
FRA-Ligue 1,2425,Lens,Gabin Capuano,,,18.0,2006.0,0.1,0,0,0,0,0,0,0,,0,0,0,0,0,0,0,0
FRA-Ligue 1,2425,Lens,Goduine Koyalipou,,,24.0,2000.0,9.8,3,2,0,3,0,1,1,100.0,0,4,0,4,1,4,8,0
FRA-Ligue 1,2425,Lens,Hamzat Ojediran,,,20.0,2003.0,4.6,28,15,12,13,3,7,19,36.8,12,10,2,8,10,38,7,0
FRA-Ligue 1,2425,Lens,Hervé Koffi,,,27.0,1996.0,5.0,1,1,1,0,0,1,1,100.0,0,0,0,0,0,1,5,0
FRA-Ligue 1,2425,Lens,Jeremy Agbonifo,,,18.0,2005.0,3.3,7,6,6,0,1,3,7,42.9,4,2,1,1,1,8,0,1
FRA-Ligue 1,2425,Lens,Jhoanner Chávez,,,22.0,2002.0,6.6,9,5,4,4,1,2,7,28.6,5,10,1,9,6,15,13,0
FRA-Ligue 1,2425,Lens,Jonathan Gradit,,,31.0,1992.0,23.5,44,23,22,19,3,23,40,57.5,17,27,12,15,25,69,122,2
FRA-Ligue 1,2425,Lens,Juma Bah,,,18.0,2006.0,7.6,16,10,6,10,0,5,7,71.4,2,10,7,3,17,33,47,1
FRA-Ligue 1,2425,Lens,Kembo Diliwidi,,,18.0,2006.0,0.0,0,0,0,0,0,0,0,,0,0,0,0,0,0,0,0
FRA-Ligue 1,2425,Lens,Kevin Danso,,,25.0,1998.0,12.0,19,7,12,5,2,12,16,75.0,4,25,19,6,20,39,62,1
FRA-Ligue 1,2425,Lens,Kyllian Antonio,,,16.0,2008.0,1.5,3,2,2,0,1,1,3,33.3,2,3,0,3,3,6,3,1
FRA-Ligue 1,2425,Lens,M'Bala Nzola,,,27.0,1996.0,16.2,5,4,0,1,4,3,9,33.3,6,9,1,8,5,10,7,0
FRA-Ligue 1,2425,Lens,Malang Sarr,,,25.0,1999.0,15.4,21,13,12,6,3,16,27,59.3,11,18,9,9,22,43,63,3
FRA-Ligue 1,2425,Lens,Martin Satriano,,,23.0,2001.0,1.0,3,1,1,1,1,3,3,100.0,0,0,0,0,0,3,2,0
FRA-Ligue 1,2425,Lens,Mathew Ryan,,,32.0,1992.0,14.0,1,0,1,0,0,1,2,50.0,1,0,0,0,1,2,2,2
FRA-Ligue 1,2425,Lens,Nampalys Mendy,,,32.0,1992.0,6.5,15,8,4,7,4,6,14,42.9,8,8,2,6,9,24,8,0
FRA-Ligue 1,2425,Lens,Neil El Aynaoui,,,23.0,2001.0,17.6,39,21,18,15,6,12,34,35.3,22,34,8,26,30,69,29,0
FRA-Ligue 1,2425,Lens,Przemysław Frankowski,,,29.0,1995.0,15.4,32,21,17,10,5,19,30,63.3,11,10,2,8,19,51,28,0
FRA-Ligue 1,2425,Lens,Rayan Fofana,,,18.0,2006.0,0.3,2,2,1,1,0,0,0,,0,0,0,0,0,2,0,0
FRA-Ligue 1,2425,Lens,Ruben Aguilar,,,31.0,1993.0,12.5,34,18,17,12,5,24,39,61.5,15,25,3,22,13,47,23,0
FRA-Ligue 1,2425,Lens,Rémy Labeau Lascary,,,21.0,2003.0,7.1,16,10,7,6,3,5,11,45.5,6,5,0,5,1,17,7,0
FRA-Ligue 1,2425,Lens,Tom Pouilly,,,21.0,2003.0,3.0,9,6,5,1,3,5,10,50.0,5,5,1,4,4,13,11,0
FRA-Ligue 1,2425,Lens,Wesley Saïd,,,29.0,1995.0,10.1,16,11,3,10,3,6,13,46.2,7,6,0,6,2,18,2,0
FRA-Ligue 1,2425,Lille,Aaron Malouda,,,18.0,2005.0,0.0,0,0,0,0,0,0,0,,0,0,0,0,0,0,0,0
FRA-Ligue 1,2425,Lille,Alexsandro Ribeiro,,,24.0,1999.0,30.0,32,19,18,13,1,20,30,66.7,10,23,13,10,27,59,143,3
FRA-Ligue 1,2425,Lille,André Gomes,,,31.0,1993.0,14.2,27,13,9,11,7,11,31,35.5,20,7,1,6,6,33,11,2
FRA-Ligue 1,2425,Lille,Angel Gomes,,,23.0,2000.0,8.2,10,6,4,4,2,2,12,16.7,10,0,0,0,0,10,2,0
FRA-Ligue 1,2425,Lille,Ayyoub Bouaddi,,,16.0,2007.0,12.8,50,31,21,21,8,19,32,59.4,13,12,3,9,10,60,12,1
FRA-Ligue 1,2425,Lille,Aïssa Mandi,,,32.0,1991.0,19.3,31,17,12,15,4,16,22,72.7,6,23,11,12,15,46,54,0
FRA-Ligue 1,2425,Lille,Bafodé Diakité,,,23.0,2001.0,30.7,31,18,17,11,3,18,26,69.2,8,30,17,13,27,58,99,5
FRA-Ligue 1,2425,Lille,Benjamin André,,,33.0,1990.0,29.9,103,57,31,60,12,54,96,56.3,42,42,6,36,48,151,56,0
FRA-Ligue 1,2425,Lille,Chuba Akpom,,,28.0,1995.0,7.1,8,5,0,4,4,2,6,33.3,4,9,0,9,0,8,3,0
FRA-Ligue 1,2425,Lille,Edon Zhegrova,,,25.0,1999.0,10.9,5,2,3,0,2,2,7,28.6,5,8,0,8,4,9,1,0
FRA-Ligue 1,2425,Lille,Ethan Mbappé,,,17.0,2006.0,2.5,6,2,3,2,1,0,4,0.0,4,6,0,6,1,7,0,0
FRA-Ligue 1,2425,Lille,Gabriel Gudmundsson,,,25.0,1999.0,19.8,36,25,15,15,6,23,36,63.9,13,19,7,12,17,53,41,3
FRA-Ligue 1,2425,Lille,Hákon Arnar Haraldsson,,,21.0,2003.0,19.5,36,16,9,17,10,16,33,48.5,17,10,2,8,8,44,6,0
FRA-Ligue 1,2425,Lille,Ismaily,,,34.0,1990.0,10.0,33,17,17,12,4,17,26,65.4,9,15,1,14,13,46,49,0
FRA-Ligue 1,2425,Lille,Jonathan David,,,24.0,2000.0,28.4,24,8,3,12,9,9,21,42.9,12,13,2,11,7,31,10,1
FRA-Ligue 1,2425,Lille,Lucas Chevalier,,,22.0,2001.0,34.0,3,2,3,0,0,3,4,75.0,1,0,0,0,0,3,13,4
FRA-Ligue 1,2425,Lille,Matias Fernandez-Pardo,,,19.0,2005.0,11.8,12,9,3,6,3,6,12,50.0,6,9,0,9,3,15,6,0
FRA-Ligue 1,2425,Lille,Mitchel Bakker,,,24.0,2000.0,12.7,23,13,6,11,6,10,19,52.6,9,10,1,9,12,35,15,0
FRA-Ligue 1,2425,Lille,Mohamed Lamine Bayo,,,26.0,1998.0,3.4,1,1,0,0,1,1,1,100.0,0,0,0,0,0,1,4,0
FRA-Ligue 1,2425,Lille,Nabil Bentaleb,,,29.0,1994.0,3.7,4,3,2,0,2,3,7,42.9,4,5,0,5,5,9,7,2
FRA-Ligue 1,2425,Lille,Ngal'Ayel Mukau,,,19.0,2004.0,13.2,33,18,9,22,2,17,29,58.6,12,14,0,14,15,48,22,0
FRA-Ligue 1,2425,Lille,Osame Sahraoui,,,23.0,2001.0,14.4,13,9,4,4,5,3,8,37.5,5,14,1,13,7,20,8,1
FRA-Ligue 1,2425,Lille,Ousmane Toure,,,19.0,2005.0,0.1,0,0,0,0,0,0,0,,0,0,0,0,1,1,2,0
FRA-Ligue 1,2425,Lille,Rémy Cabella,,,34.0,1990.0,11.2,39,19,16,13,10,19,33,57.6,14,10,1,9,8,47,5,0
FRA-Ligue 1,2425,Lille,Thomas Meunier,,,32.0,1991.0,21.4,53,38,32,15,6,33,49,67.3,16,21,8,13,34,87,64,0
FRA-Ligue 1,2425,Lille,Tiago Santos,,,22.0,2002.0,4.5,12,7,4,5,3,6,9,66.7,3,2,0,2,2,14,4,0
FRA-Ligue 1,2425,Lille,Younes Lachaab,,,19.0,2005.0,0.1,1,1,0,0,1,1,1,100.0,0,0,0,0,1,2,0,0
FRA-Ligue 1,2425,Lyon,Abner,,,24.0,2000.0,12.1,29,20,12,10,7,21,32,65.6,11,15,2,13,5,34,41,0
FRA-Ligue 1,2425,Lyon,Adryelson,,,26.0,1998.0,0.0,0,0,0,0,0,0,0,,0,0,0,0,1,1,1,0
FRA-Ligue 1,2425,Lyon,Ainsley Maitland-Niles,,,26.0,1997.0,22.1,71,44,30,26,15,48,76,63.2,28,28,4,24,25,96,61,6
FRA-Ligue 1,2425,Lyon,Alejandro Rodriguez,,,16.0,2008.0,0.2,0,0,0,0,0,0,0,,0,0,0,0,0,0,0,0
FRA-Ligue 1,2425,Lyon,Alexandre Lacazette,,,33.0,1991.0,22.8,13,6,3,7,3,5,16,31.3,11,13,3,10,8,21,7,0
FRA-Ligue 1,2425,Lyon,Clinton Mata,,,31.0,1992.0,26.3,41,29,23,14,4,28,36,77.8,8,26,17,9,46,87,72,3
FRA-Ligue 1,2425,Lyon,Corentin Tolisso,,,29.0,1994.0,25.9,57,25,21,26,10,34,65,52.3,31,52,13,39,22,79,41,1
FRA-Ligue 1,2425,Lyon,Duje Ćaleta-Car,,,27.0,1996.0,17.6,20,12,11,9,0,10,19,52.6,9,33,25,8,17,37,97,2
FRA-Ligue 1,2425,Lyon,Ernest Nuamah,,,20.0,2003.0,11.7,21,11,15,4,2,12,27,44.4,15,9,1,8,8,29,8,1
FRA-Ligue 1,2425,Lyon,Georges Mikautadze,,,23.0,2000.0,16.1,7,6,1,3,3,3,9,33.3,6,11,0,11,4,11,6,0
FRA-Ligue 1,2425,Lyon,Gift Orban,,,22.0,2002.0,2.1,0,0,0,0,0,0,1,0.0,1,0,0,0,0,0,0,0
FRA-Ligue 1,2425,Lyon,Jordan Veretout,,,31.0,1993.0,17.3,30,14,14,14,2,17,40,42.5,23,17,3,14,5,35,23,1
FRA-Ligue 1,2425,Lyon,Lucas Perri,,,26.0,1997.0,33.0,1,1,1,0,0,0,4,0.0,4,1,0,1,0,1,22,1
FRA-Ligue 1,2425,Lyon,Mahamadou Diawara,,,19.0,2005.0,0.2,1,0,0,1,0,1,3,33.3,2,2,0,2,0,1,0,0
FRA-Ligue 1,2425,Lyon,Malick Fofana,,,19.0,2005.0,17.7,22,11,8,11,3,8,17,47.1,9,12,0,12,8,30,6,0
FRA-Ligue 1,2425,Lyon,Mama Samba Baldé,,,28.0,1995.0,0.4,2,2,0,2,0,0,0,,0,0,0,0,1,3,1,0
FRA-Ligue 1,2425,Lyon,Maxence Caqueret,,,24.0,2000.0,6.4,21,11,5,11,5,4,22,18.2,18,12,2,10,7,28,2,0
FRA-Ligue 1,2425,Lyon,Moussa Niakhate,,,28.0,1996.0,30.3,47,27,37,8,2,24,32,75.0,8,26,17,9,25,72,143,3
FRA-Ligue 1,2425,Lyon,Nemanja Matić,,,35.0,1988.0,22.3,42,29,15,21,6,23,41,56.1,18,21,9,12,18,60,31,1
FRA-Ligue 1,2425,Lyon,Nicolás Tagliafico,,,31.0,1992.0,21.1,57,37,24,22,11,29,48,60.4,19,25,7,18,36,93,55,0
FRA-Ligue 1,2425,Lyon,Orel Mangala,,,26.0,1998.0,0.7,1,0,0,0,1,0,1,0.0,1,2,0,2,0,1,1,0
FRA-Ligue 1,2425,Lyon,Paul Akouokou,,,26.0,1997.0,0.2,1,0,0,1,0,0,0,,0,0,0,0,1,2,0,1
FRA-Ligue 1,2425,Lyon,Rayan Cherki,,,20.0,2003.0,22.7,15,12,3,8,4,6,28,21.4,22,6,0,6,7,22,6,0
FRA-Ligue 1,2425,Lyon,Rémy Descamps,,,28.0,1996.0,1.0,0,0,0,0,0,0,0,,0,0,0,0,0,0,0,0
FRA-Ligue 1,2425,Lyon,Sael Kumbedi,,,19.0,2005.0,10.6,28,14,11,13,4,14,20,70.0,6,11,3,8,8,36,32,1
FRA-Ligue 1,2425,Lyon,Saïd Benrahma,,,28.0,1995.0,8.2,9,5,4,4,1,3,10,30.0,7,6,0,6,3,12,2,0
FRA-Ligue 1,2425,Lyon,Tanner Tessmann,,,22.0,2001.0,13.7,25,15,11,10,4,12,25,48.0,13,13,7,6,19,44,29,1
FRA-Ligue 1,2425,Lyon,Thiago Almada,,,23.0,2001.0,10.6,14,8,7,5,2,7,21,33.3,14,2,0,2,7,21,6,3
FRA-Ligue 1,2425,Lyon,Téo Barisic,,,19.0,2004.0,0.0,0,0,0,0,0,0,0,,0,0,0,0,0,0,1,0
FRA-Ligue 1,2425,Lyon,Warmed Omari,,,24.0,2000.0,0.1,0,0,0,0,0,0,0,,0,0,0,0,0,0,1,0
FRA-Ligue 1,2425,Lyon,Wilfried Zaha,,,31.0,1992.0,0.8,1,1,1,0,0,1,2,50.0,1,3,0,3,1,2,0,0
FRA-Ligue 1,2425,Marseille,Adrien Rabiot,,,29.0,1995.0,27.6,49,31,17,21,11,19,32,59.4,13,21,2,19,21,70,32,0
FRA-Ligue 1,2425,Marseille,Amar Dedić,,,21.0,2002.0,3.5,5,4,2,2,1,3,10,30.0,7,0,0,0,3,8,12,1
FRA-Ligue 1,2425,Marseille,Amine Gouiri,,,24.0,2000.0,11.6,5,5,0,1,4,2,3,66.7,1,9,0,9,1,6,1,0
FRA-Ligue 1,2425,Marseille,Amine Harit,,,27.0,1997.0,5.8,8,7,0,6,2,1,2,50.0,1,6,0,6,3,11,1,1
FRA-Ligue 1,2425,Marseille,Bamo Meïté,,,22.0,2001.0,0.3,0,0,0,0,0,0,0,,0,0,0,0,0,0,1,0
FRA-Ligue 1,2425,Marseille,Bilal Nadir,,,20.0,2003.0,4.3,10,3,4,6,0,4,6,66.7,2,6,1,5,4,14,7,0
FRA-Ligue 1,2425,Marseille,Darryl Bakola,,,16.0,2007.0,0.2,1,1,0,1,0,0,0,,0,0,0,0,0,1,0,0
FRA-Ligue 1,2425,Marseille,Derek Cornelius,,,26.0,1997.0,15.8,24,17,15,8,1,17,22,77.3,5,16,10,6,14,38,51,0
FRA-Ligue 1,2425,Marseille,Elye Wahi,,,21.0,2003.0,6.4,0,0,0,0,0,0,4,0.0,4,1,0,1,1,1,0,0
FRA-Ligue 1,2425,Marseille,Emmanuel Koum Mbondo,,,18.0,2006.0,0.1,0,0,0,0,0,0,0,,0,0,0,0,0,0,0,0
FRA-Ligue 1,2425,Marseille,Enzo Sternal,,,17.0,2007.0,0.3,0,0,0,0,0,0,0,,0,0,0,0,0,0,0,0
FRA-Ligue 1,2425,Marseille,Faris Pemi Moumbagna,,,24.0,2000.0,0.1,0,0,0,0,0,0,0,,0,0,0,0,0,0,0,0
FRA-Ligue 1,2425,Marseille,Geoffrey Kondogbia,,,31.0,1993.0,22.4,60,38,31,26,3,27,34,79.4,7,23,6,17,22,82,64,4
FRA-Ligue 1,2425,Marseille,Gerónimo Rulli,,,32.0,1992.0,34.0,4,3,4,0,0,4,8,50.0,4,1,0,1,1,5,25,3
FRA-Ligue 1,2425,Marseille,Ismaël Bennacer,,,26.0,1997.0,7.2,21,10,8,12,1,12,18,66.7,6,6,0,6,10,31,2,1
FRA-Ligue 1,2425,Marseille,Ismaël Koné,,,22.0,2002.0,4.0,8,4,3,3,2,3,4,75.0,1,4,1,3,4,12,2,1
FRA-Ligue 1,2425,Marseille,Jon Rowe,,,21.0,2003.0,9.0,15,11,5,4,6,6,14,42.9,8,4,1,3,2,17,4,0
FRA-Ligue 1,2425,Marseille,Keyliane Abdallah,,,18.0,2006.0,0.0,1,1,1,0,0,1,1,100.0,0,0,0,0,0,1,0,0
FRA-Ligue 1,2425,Marseille,Leonardo Balerdi,,,25.0,1999.0,25.3,54,39,32,17,5,27,47,57.4,20,25,14,11,38,92,72,4
FRA-Ligue 1,2425,Marseille,Lilian Brassier,,,24.0,1999.0,8.7,8,6,8,0,0,5,6,83.3,1,8,3,5,9,17,28,2
FRA-Ligue 1,2425,Marseille,Luis Henrique,,,22.0,2001.0,29.0,16,9,7,6,3,9,10,90.0,1,15,2,13,10,26,30,0
FRA-Ligue 1,2425,Marseille,Luiz Felipe,,,27.0,1997.0,1.4,4,3,3,1,0,1,2,50.0,1,3,2,1,3,7,5,0
FRA-Ligue 1,2425,Marseille,Mason Greenwood,,,22.0,2001.0,31.2,35,18,10,14,11,16,39,41.0,23,7,0,7,12,47,5,2
FRA-Ligue 1,2425,Marseille,Michael Amir Murillo,,,28.0,1996.0,27.1,49,31,30,13,6,32,46,69.6,14,21,8,13,18,67,70,4
FRA-Ligue 1,2425,Marseille,Neal Maupay,,,27.0,1996.0,11.6,9,4,1,6,2,3,6,50.0,3,5,0,5,2,11,0,0
FRA-Ligue 1,2425,Marseille,Pierre Højbjerg,,,28.0,1995.0,29.6,64,45,25,32,7,37,69,53.6,32,28,4,24,42,106,33,2
FRA-Ligue 1,2425,Marseille,Pol Lirola,,,26.0,1997.0,7.6,13,9,5,8,0,5,13,38.5,8,7,2,5,4,17,12,0
FRA-Ligue 1,2425,Marseille,Quentin Merlin,,,22.0,2002.0,17.7,22,17,12,5,5,9,16,56.3,7,20,4,16,14,36,17,1
FRA-Ligue 1,2425,Marseille,Robinio Vaz,,,17.0,2007.0,0.8,1,1,0,0,1,0,2,0.0,2,0,0,0,0,1,2,0
FRA-Ligue 1,2425,Marseille,Ulisses Garcia,,,28.0,1996.0,10.3,14,11,7,5,2,4,14,28.6,10,5,1,4,8,22,18,0
FRA-Ligue 1,2425,Marseille,Valentin Carboni,,,19.0,2005.0,1.1,2,2,0,1,1,0,1,0.0,1,1,0,1,1,3,1,0
FRA-Ligue 1,2425,Marseille,Valentin Rongier,,,29.0,1994.0,17.4,50,28,14,31,5,27,43,62.8,16,30,9,21,33,83,28,5
FRA-Ligue 1,2425,Monaco,Aleksandr Golovin,,,28.0,1996.0,12.8,38,24,9,20,9,17,39,43.6,22,16,4,12,12,50,7,0
FRA-Ligue 1,2425,Monaco,Almoatasem Al Musrati,,,28.0,1996.0,4.3,14,11,5,8,1,7,11,63.6,4,3,1,2,5,19,9,0
FRA-Ligue 1,2425,Monaco,Breel Embolo,,,27.0,1997.0,20.5,22,17,7,7,8,5,16,31.3,11,11,0,11,3,25,10,1
FRA-Ligue 1,2425,Monaco,Caio Henrique Oliveira Silva,,,27.0,1997.0,21.4,37,26,16,19,2,23,44,52.3,21,26,8,18,22,59,59,0
FRA-Ligue 1,2425,Monaco,Christian Mawissa,,,19.0,2005.0,16.7,42,29,27,13,2,26,44,59.1,18,25,6,19,26,68,48,1
FRA-Ligue 1,2425,Monaco,Denis Zakaria,,,27.0,1996.0,23.8,41,26,15,19,7,24,33,72.7,9,31,8,23,34,75,39,1
FRA-Ligue 1,2425,Monaco,Eliesse Ben Seghir,,,19.0,2005.0,19.4,31,22,12,12,7,18,32,56.3,14,20,0,20,13,44,4,0
FRA-Ligue 1,2425,Monaco,Eliot Matazo,,,22.0,2002.0,0.8,3,2,0,3,0,0,0,,0,0,0,0,1,4,2,0
FRA-Ligue 1,2425,Monaco,Folarin Balogun,,,23.0,2001.0,6.8,1,1,0,0,1,0,4,0.0,4,0,0,0,1,2,0,0
FRA-Ligue 1,2425,Monaco,George Ilenikhena,,,17.0,2006.0,8.0,4,2,0,3,1,1,2,50.0,1,0,0,0,2,6,0,0
FRA-Ligue 1,2425,Monaco,Ismail Jakobs,,,24.0,1999.0,2.0,5,5,3,0,2,3,5,60.0,2,0,0,0,2,7,6,0
FRA-Ligue 1,2425,Monaco,Jordan Teze,,,24.0,1999.0,6.3,18,9,8,9,1,7,16,43.8,9,12,1,11,6,24,15,0
FRA-Ligue 1,2425,Monaco,Kassoum Ouattara,,,19.0,2004.0,4.3,9,7,5,4,0,4,14,28.6,10,6,0,6,5,14,2,1
FRA-Ligue 1,2425,Monaco,Krépin Diatta,,,25.0,1999.0,5.6,18,12,13,2,3,14,24,58.3,10,5,1,4,9,27,12,2
FRA-Ligue 1,2425,Monaco,Lamine Camara,,,20.0,2004.0,22.8,66,41,22,34,10,26,48,54.2,22,30,4,26,31,97,32,1
FRA-Ligue 1,2425,Monaco,Lucas Michal,,,19.0,2005.0,1.3,5,3,3,2,0,2,4,50.0,2,2,0,2,1,6,2,0
FRA-Ligue 1,2425,Monaco,Maghnes Akliouche,,,22.0,2002.0,26.7,51,31,12,24,15,19,41,46.3,22,21,0,21,15,66,13,0
FRA-Ligue 1,2425,Monaco,Mamadou Coulibaly,,,20.0,2004.0,0.1,1,0,0,1,0,0,0,,0,0,0,0,0,1,0,0
FRA-Ligue 1,2425,Monaco,Mika Biereth,,,21.0,2003.0,13.6,5,5,0,3,2,3,7,42.9,4,11,0,11,4,9,7,0
FRA-Ligue 1,2425,Monaco,Mohammed Salisu,,,25.0,1999.0,11.4,28,18,16,11,1,13,16,81.3,3,10,8,2,16,44,54,2
FRA-Ligue 1,2425,Monaco,Philipp Köhn,,,26.0,1998.0,19.0,0,0,0,0,0,0,1,0.0,1,0,0,0,0,0,11,2
FRA-Ligue 1,2425,Monaco,Radosław Majecki,,,24.0,1999.0,15.0,0,0,0,0,0,0,2,0.0,2,0,0,0,0,0,8,1
FRA-Ligue 1,2425,Monaco,Saïmon Bouabré,,,18.0,2006.0,1.1,1,0,0,1,0,0,3,0.0,3,1,0,1,0,1,0,0
FRA-Ligue 1,2425,Monaco,Soungoutou Magassa,,,20.0,2003.0,11.4,47,25,14,27,6,25,46,54.3,21,16,3,13,21,68,19,1
FRA-Ligue 1,2425,Monaco,Takumi Minamino,,,29.0,1995.0,24.8,33,19,7,14,12,15,42,35.7,27,26,1,25,10,43,20,0
FRA-Ligue 1,2425,Monaco,Thilo Kehrer,,,27.0,1996.0,26.5,37,23,26,11,0,22,38,57.9,16,18,10,8,36,73,113,1
FRA-Ligue 1,2425,Monaco,Vanderson,,,23.0,2001.0,22.9,76,48,37,30,9,45,64,70.3,19,43,6,37,39,115,65,2
FRA-Ligue 1,2425,Monaco,Wilfried Singo,,,23.0,2000.0,23.3,37,23,24,10,3,20,28,71.4,8,17,9,8,43,80,110,2
FRA-Ligue 1,2425,Montpellier,Akor Adams,,,24.0,2000.0,11.9,4,3,1,2,1,3,4,75.0,1,2,1,1,1,5,5,1
FRA-Ligue 1,2425,Montpellier,Andy Delort,,,32.0,1991.0,6.7,4,3,1,2,1,1,2,50.0,1,3,1,2,0,4,3,0
FRA-Ligue 1,2425,Montpellier,Arnaud Nordin,,,26.0,1998.0,13.0,24,15,6,16,2,11,21,52.4,10,12,0,12,5,29,7,0
FRA-Ligue 1,2425,Montpellier,Axel Gueguin,,,19.0,2005.0,0.3,1,1,0,1,0,1,1,100.0,0,0,0,0,0,1,0,0
FRA-Ligue 1,2425,Montpellier,Bamo Meïté,,,22.0,2001.0,4.7,5,3,2,1,2,1,2,50.0,1,3,3,0,4,9,14,3
FRA-Ligue 1,2425,Montpellier,Becir Omeragic,,,22.0,2002.0,20.0,32,16,19,12,1,16,21,76.2,5,32,21,11,13,45,78,0
FRA-Ligue 1,2425,Montpellier,Benjamin Lecomte,,,33.0,1991.0,30.0,0,0,0,0,0,0,0,,0,0,0,0,0,0,18,2
FRA-Ligue 1,2425,Montpellier,Birama Touré,,,32.0,1992.0,3.3,8,5,5,2,1,4,6,66.7,2,3,2,1,6,14,7,0
FRA-Ligue 1,2425,Montpellier,Boubakar Kouyaté,,,27.0,1997.0,8.4,22,17,16,6,0,11,19,57.9,8,17,11,6,12,34,54,0
FRA-Ligue 1,2425,Montpellier,Dimitry Bertaud,,,26.0,1998.0,4.0,0,0,0,0,0,0,0,,0,0,0,0,0,0,2,0
FRA-Ligue 1,2425,Montpellier,Enzo Tchato,,,21.0,2002.0,21.1,48,26,26,18,4,26,44,59.1,18,30,10,20,22,70,59,0
FRA-Ligue 1,2425,Montpellier,Falaye Sacko,,,29.0,1995.0,13.7,14,8,9,4,1,9,19,47.4,10,17,7,10,13,27,21,0
FRA-Ligue 1,2425,Montpellier,Gabriel Bares,,,23.0,2000.0,0.6,2,2,2,0,0,1,2,50.0,1,0,0,0,1,3,3,0
FRA-Ligue 1,2425,Montpellier,Issiaga Sylla,,,30.0,1994.0,12.8,25,10,17,7,1,15,29,51.7,14,13,4,9,10,35,34,1
FRA-Ligue 1,2425,Montpellier,Jordan Ferri,,,32.0,1992.0,19.7,42,23,18,22,2,18,44,40.9,26,20,3,17,9,51,20,0
FRA-Ligue 1,2425,Montpellier,Joris Chotard,,,22.0,2001.0,21.0,39,27,17,20,2,20,46,43.5,26,28,10,18,19,58,52,1
FRA-Ligue 1,2425,Montpellier,Junior Ndiaye,,,19.0,2005.0,4.9,3,2,2,1,0,1,4,25.0,3,2,1,1,0,3,2,0
FRA-Ligue 1,2425,Montpellier,Khalil Fayad,,,20.0,2004.0,11.4,31,16,12,17,2,15,28,53.6,13,18,1,17,10,41,15,1
FRA-Ligue 1,2425,Montpellier,Lucas Mincarelli,,,20.0,2004.0,7.9,17,10,6,9,2,6,13,46.2,7,8,5,3,9,26,27,0
FRA-Ligue 1,2425,Montpellier,Modibo Sagnan,,,25.0,1999.0,23.8,57,35,38,16,3,26,44,59.1,18,24,13,11,29,86,110,5
FRA-Ligue 1,2425,Montpellier,Musa Al-Taamari,,,27.0,1997.0,12.4,14,10,4,5,5,8,15,53.3,7,2,0,2,3,17,3,2
FRA-Ligue 1,2425,Montpellier,Nicolas Pays,,,20.0,2003.0,5.0,13,6,3,4,6,4,8,50.0,4,1,0,1,4,17,2,0
FRA-Ligue 1,2425,Montpellier,Nikola Maksimović,,,32.0,1991.0,6.5,9,5,6,3,0,6,7,85.7,1,5,4,1,6,15,30,1
FRA-Ligue 1,2425,Montpellier,Othmane Maamma,,,18.0,2005.0,4.0,3,1,2,1,0,1,4,25.0,3,4,0,4,1,4,2,1
FRA-Ligue 1,2425,Montpellier,Rabby Nzingoula,,,18.0,2005.0,18.8,64,42,26,31,7,27,58,46.6,31,27,5,22,29,93,23,0
FRA-Ligue 1,2425,Montpellier,Simon Cara,,,19.0,2005.0,0.1,0,0,0,0,0,0,0,,0,0,0,0,0,0,0,0
FRA-Ligue 1,2425,Montpellier,Stefan Džodić,,,19.0,2005.0,2.7,8,5,3,5,0,5,8,62.5,3,5,4,1,5,13,10,1
FRA-Ligue 1,2425,Montpellier,Tanguy Coulibaly,,,23.0,2001.0,16.5,32,24,13,15,4,14,33,42.4,19,18,2,16,11,43,3,1
FRA-Ligue 1,2425,Montpellier,Théo Chennahi,,,19.0,2005.0,2.0,6,3,3,3,0,4,7,57.1,3,3,0,3,2,8,6,0
FRA-Ligue 1,2425,Montpellier,Théo Sainte-Luce,,,25.0,1998.0,11.3,24,11,16,4,4,16,33,48.5,17,16,4,12,12,36,33,1
FRA-Ligue 1,2425,Montpellier,Téji Savanier,,,32.0,1991.0,26.3,29,25,7,16,6,18,43,41.9,25,16,1,15,15,44,21,4
FRA-Ligue 1,2425,Montpellier,Wahbi Khazri,,,33.0,1991.0,12.4,25,18,5,16,4,8,21,38.1,13,13,1,12,5,30,7,0
FRA-Ligue 1,2425,Montpellier,Wilfried Ndollo,,,19.0,2005.0,4.5,6,5,4,1,1,4,8,50.0,4,9,1,8,7,13,11,0
FRA-Ligue 1,2425,Montpellier,Yael Mouanga,,,19.0,2005.0,10.5,14,8,9,3,2,7,9,77.8,2,16,8,8,10,24,50,0
FRA-Ligue 1,2425,Montpellier,Yanis Issoufou,,,17.0,2006.0,0.9,6,4,4,1,1,3,5,60.0,2,1,0,1,0,6,1,0
FRA-Ligue 1,2425,Nantes,Alban Lafont,,,25.0,1999.0,12.0,1,1,1,0,0,1,1,100.0,0,2,0,2,0,1,8,1
FRA-Ligue 1,2425,Nantes,Anthony Lopes,,,33.0,1990.0,17.4,1,0,1,0,0,1,1,100.0,0,0,0,0,1,2,7,1
FRA-Ligue 1,2425,Nantes,Bahereba Guirassy,,,17.0,2006.0,3.9,12,8,6,3,3,7,13,53.8,6,10,0,10,1,13,4,0
FRA-Ligue 1,2425,Nantes,Dehmaine Assoumani,,,19.0,2005.0,1.1,6,3,0,4,2,4,5,80.0,1,1,0,1,1,7,4,0
FRA-Ligue 1,2425,Nantes,Douglas,,,27.0,1997.0,25.6,69,42,29,31,9,26,44,59.1,18,51,11,40,32,101,47,0
FRA-Ligue 1,2425,Nantes,Fabien Centonze,,,28.0,1996.0,2.9,8,4,5,2,1,4,6,66.7,2,4,1,3,2,10,17,0
FRA-Ligue 1,2425,Nantes,Florent Mollet,,,32.0,1991.0,2.7,2,2,1,1,0,1,1,100.0,0,2,0,2,1,3,4,0
FRA-Ligue 1,2425,Nantes,Francis Coquelin,,,33.0,1991.0,2.5,9,5,5,3,1,3,4,75.0,1,3,1,2,6,15,3,0
FRA-Ligue 1,2425,Nantes,Ignatius Ganago,,,25.0,1999.0,2.7,1,1,0,1,0,1,2,50.0,1,3,1,2,4,5,2,0
FRA-Ligue 1,2425,Nantes,Jean-Charles Castelletto,,,29.0,1995.0,29.1,34,17,17,15,2,17,27,63.0,10,27,18,9,25,59,151,0
FRA-Ligue 1,2425,Nantes,Jean-Kevin Duverne,,,27.0,1997.0,6.0,21,12,13,4,4,15,27,55.6,12,10,3,7,8,29,23,0
FRA-Ligue 1,2425,Nantes,Jean-Philippe Gbamin,,,28.0,1995.0,2.4,2,1,0,2,0,1,4,25.0,3,5,2,3,3,5,2,0
FRA-Ligue 1,2425,Nantes,Johann Lepenant,,,21.0,2002.0,22.8,68,33,30,27,11,32,71,45.1,39,35,3,32,18,86,25,0
FRA-Ligue 1,2425,Nantes,Kelvin Amian,,,26.0,1998.0,24.1,55,31,40,14,1,29,35,82.9,6,18,11,7,13,68,85,0
FRA-Ligue 1,2425,Nantes,Louis Leroux,,,18.0,2006.0,9.1,25,18,10,12,3,16,22,72.7,6,22,2,20,8,33,19,1
FRA-Ligue 1,2425,Nantes,Marcus Coco,,,28.0,1996.0,10.6,27,21,15,9,3,16,31,51.6,15,16,5,11,11,38,46,0
FRA-Ligue 1,2425,Nantes,Matthis Abline,,,21.0,2003.0,30.8,11,5,2,4,5,3,9,33.3,6,15,1,14,4,15,36,1
FRA-Ligue 1,2425,Nantes,Meschak Elia,,,26.0,1997.0,1.9,7,5,3,2,2,1,1,100.0,0,3,0,3,0,7,2,0
FRA-Ligue 1,2425,Nantes,Moses Simon,,,29.0,1995.0,29.0,20,14,4,7,9,7,22,31.8,15,11,0,11,12,32,13,0
FRA-Ligue 1,2425,Nantes,Mostafa Mohamed,,,26.0,1997.0,13.9,18,9,6,8,4,4,12,33.3,8,10,2,8,10,28,27,0
FRA-Ligue 1,2425,Nantes,Nathan Zeze,,,19.0,2005.0,16.8,38,22,22,16,0,23,33,69.7,10,22,9,13,23,61,120,1
FRA-Ligue 1,2425,Nantes,Nicolas Cozza,,,25.0,1999.0,22.8,59,41,35,18,6,31,47,66.0,16,25,10,15,25,84,69,0
FRA-Ligue 1,2425,Nantes,Nicolas Pallois,,,36.0,1987.0,22.4,61,27,44,13,4,37,63,58.7,26,48,18,30,28,89,164,3
FRA-Ligue 1,2425,Nantes,Patrik Carlgren,,,32.0,1992.0,4.6,0,0,0,0,0,0,0,,0,0,0,0,0,0,0,0
FRA-Ligue 1,2425,Nantes,Pedro Chirivella,,,27.0,1997.0,26.1,44,29,23,16,5,19,42,45.2,23,25,4,21,19,63,45,0
FRA-Ligue 1,2425,Nantes,Plamedi Nsingi,,,23.0,2000.0,0.2,1,0,1,0,0,0,1,0.0,1,0,0,0,0,1,0,0
FRA-Ligue 1,2425,Nantes,Saidou Sow,,,22.0,2002.0,8.9,17,11,13,4,0,6,10,60.0,4,19,12,7,13,30,46,1
FRA-Ligue 1,2425,Nantes,Sorba Thomas,,,24.0,1999.0,14.7,14,6,7,5,2,10,18,55.6,8,12,2,10,9,23,27,1
FRA-Ligue 1,2425,Nantes,Sékou Doucoure,,,19.0,2005.0,0.1,0,0,0,0,0,0,0,,0,0,0,0,0,0,3,0
FRA-Ligue 1,2425,Nantes,Tino Kadewere,,,28.0,1996.0,5.7,14,8,5,3,6,6,13,46.2,7,3,0,3,6,20,8,0
FRA-Ligue 1,2425,Nice,Ali Abdi,,,30.0,1993.0,15.5,43,25,18,14,11,28,43,65.1,15,20,6,14,20,63,37,0
FRA-Ligue 1,2425,Nice,Amidou Doumbouya,,,16.0,2007.0,0.5,1,1,0,0,1,1,1,100.0,0,3,1,2,1,2,1,0
FRA-Ligue 1,2425,Nice,Antoine Mendy,,,20.0,2004.0,9.2,30,21,16,14,0,19,29,65.5,10,9,5,4,8,38,29,1
FRA-Ligue 1,2425,Nice,Badredine Bouanani,,,19.0,2004.0,12.2,11,4,4,4,3,6,18,33.3,12,16,3,13,11,22,4,0
FRA-Ligue 1,2425,Nice,Baptiste Santamaria,,,29.0,1995.0,10.3,20,10,10,7,3,13,22,59.1,9,14,3,11,18,38,19,1
FRA-Ligue 1,2425,Nice,Bernard Nguene,,,17.0,2006.0,0.1,0,0,0,0,0,0,0,,0,0,0,0,0,0,0,0
FRA-Ligue 1,2425,Nice,Bilal Brahimi,,,24.0,2000.0,0.8,0,0,0,0,0,0,0,,0,1,0,1,0,0,2,0
FRA-Ligue 1,2425,Nice,Dante,,,40.0,1983.0,21.8,32,15,17,13,2,15,29,51.7,14,29,14,15,34,66,74,1
FRA-Ligue 1,2425,Nice,Evann Guessand,,,23.0,2001.0,28.5,44,29,12,15,17,6,14,42.9,8,27,3,24,15,59,16,0
FRA-Ligue 1,2425,Nice,Gaëtan Laborde,,,30.0,1994.0,20.3,19,13,9,8,2,9,22,40.9,13,16,4,12,6,25,20,0
FRA-Ligue 1,2425,Nice,Hicham Boudaoui,,,24.0,1999.0,27.1,76,52,28,37,11,31,53,58.5,22,40,11,29,22,98,45,1
FRA-Ligue 1,2425,Nice,Issiaga Camara,,,19.0,2005.0,0.2,2,1,0,2,0,0,1,0.0,1,0,0,0,3,5,0,0
FRA-Ligue 1,2425,Nice,Jeremie Boga,,,27.0,1997.0,11.7,10,5,2,5,3,4,8,50.0,4,13,0,13,3,13,2,1
FRA-Ligue 1,2425,Nice,Jonathan Clauss,,,31.0,1992.0,25.6,52,35,27,19,6,28,56,50.0,28,25,2,23,48,100,68,3
FRA-Ligue 1,2425,Nice,Jordan Lotomba,,,25.0,1998.0,0.4,0,0,0,0,0,0,0,,0,0,0,0,0,0,1,0
FRA-Ligue 1,2425,Nice,Marcin Bułka,,,24.0,1999.0,34.0,0,0,0,0,0,0,1,0.0,1,0,0,0,0,0,16,6
FRA-Ligue 1,2425,Nice,Melvin Bard,,,23.0,2000.0,21.5,53,36,35,13,5,24,42,57.1,18,38,13,25,29,82,60,3
FRA-Ligue 1,2425,Nice,Mohamed Abdelmoneim,,,25.0,1999.0,9.5,21,14,12,6,3,13,22,59.1,9,11,5,6,15,36,56,1
FRA-Ligue 1,2425,Nice,Mohamed Ali Cho,,,20.0,2004.0,18.0,13,9,4,5,4,4,12,33.3,8,17,1,16,5,18,8,0
FRA-Ligue 1,2425,Nice,Morgan Sanson,,,29.0,1994.0,2.6,6,3,2,4,0,1,3,33.3,2,3,0,3,4,10,2,0
FRA-Ligue 1,2425,Nice,Moïse Bombito,,,24.0,2000.0,24.4,37,25,22,12,3,24,35,68.6,11,35,19,16,18,55,121,7
FRA-Ligue 1,2425,Nice,Pablo Rosario,,,27.0,1997.0,19.7,30,20,6,19,5,11,20,55.0,9,19,11,8,31,61,43,2
FRA-Ligue 1,2425,Nice,Rareş Ilie,,,21.0,2003.0,0.1,1,1,1,0,0,1,1,100.0,0,0,0,0,0,1,0,0
FRA-Ligue 1,2425,Nice,Sofiane Diop,,,24.0,2000.0,11.8,23,16,16,3,4,9,22,40.9,13,19,2,17,17,40,7,1
FRA-Ligue 1,2425,Nice,Tanguy Ndombele,,,27.0,1996.0,12.6,35,23,10,21,4,12,20,60.0,8,9,0,9,14,49,9,0
FRA-Ligue 1,2425,Nice,Terem Moffi,,,25.0,1999.0,0.6,0,0,0,0,0,0,0,,0,0,0,0,0,0,0,0
FRA-Ligue 1,2425,Nice,Tom Louchet,,,21.0,2003.0,8.6,27,17,17,5,5,17,23,73.9,6,12,4,8,18,45,20,0
FRA-Ligue 1,2425,Nice,Victor Orakpo,,,18.0,2006.0,0.4,0,0,0,0,0,0,0,,0,0,0,0,0,0,0,0
FRA-Ligue 1,2425,Nice,Yael Nandjou,,,19.0,2005.0,1.7,4,1,2,1,1,4,8,50.0,4,4,1,3,4,8,7,0
FRA-Ligue 1,2425,Nice,Youssouf Ndayishimiye,,,25.0,1998.0,21.5,40,21,25,14,1,16,27,59.3,11,35,19,16,21,61,117,4
FRA-Ligue 1,2425,Nice,Youssoufa Moukoko,,,19.0,2004.0,2.3,3,2,2,1,0,1,2,50.0,1,2,0,2,0,3,0,0
FRA-Ligue 1,2425,Paris S-G,Achraf Hakimi,,,25.0,1998.0,23.0,48,36,18,20,10,27,55,49.1,28,25,2,23,31,79,18,3
FRA-Ligue 1,2425,Paris S-G,Arnau Tenas,,,23.0,2001.0,1.0,0,0,0,0,0,0,0,,0,0,0,0,0,0,0,0
FRA-Ligue 1,2425,Paris S-G,Axel Tapé,,,16.0,2007.0,2.0,3,1,1,2,0,2,2,100.0,0,2,2,0,1,4,5,0
FRA-Ligue 1,2425,Paris S-G,Bradley Barcola,,,21.0,2002.0,24.2,27,17,10,8,9,8,31,25.8,23,25,2,23,19,46,12,0
FRA-Ligue 1,2425,Paris S-G,Désiré Doué,,,19.0,2005.0,19.2,48,30,15,19,14,24,51,47.1,27,26,0,26,13,61,7,0
FRA-Ligue 1,2425,Paris S-G,Fabián Ruiz Peña,,,28.0,1996.0,21.4,37,24,13,15,9,21,47,44.7,26,25,3,22,16,53,27,1
FRA-Ligue 1,2425,Paris S-G,Gianluigi Donnarumma,,,25.0,1999.0,23.2,1,1,1,0,0,1,2,50.0,1,0,0,0,0,1,14,0
FRA-Ligue 1,2425,Paris S-G,Gonçalo Ramos,,,23.0,2001.0,11.8,11,6,5,5,1,3,6,50.0,3,5,1,4,0,11,5,0
FRA-Ligue 1,2425,Paris S-G,Ibrahim Mbaye,,,16.0,2008.0,3.8,4,2,1,2,1,3,8,37.5,5,2,0,2,2,6,2,0
FRA-Ligue 1,2425,Paris S-G,João Neves,,,19.0,2004.0,20.5,63,31,20,26,17,27,45,60.0,18,29,9,20,23,86,22,1
FRA-Ligue 1,2425,Paris S-G,Khvicha Kvaratskhelia,,,23.0,2001.0,10.2,19,13,4,12,3,13,23,56.5,10,7,0,7,2,21,4,0
FRA-Ligue 1,2425,Paris S-G,Lee Kang-in,,,23.0,2001.0,18.5,25,17,7,11,7,19,35,54.3,16,11,1,10,3,28,3,1
FRA-Ligue 1,2425,Paris S-G,Lucas Beraldo,,,20.0,2003.0,22.3,38,31,30,8,0,23,37,62.2,14,16,8,8,21,59,63,3
FRA-Ligue 1,2425,Paris S-G,Lucas Hernández,,,28.0,1996.0,9.7,24,18,13,9,2,14,23,60.9,9,12,5,7,7,31,37,2
FRA-Ligue 1,2425,Paris S-G,Marco Asensio,,,28.0,1996.0,6.9,4,3,1,3,0,0,6,0.0,6,1,0,1,0,4,1,0
FRA-Ligue 1,2425,Paris S-G,Marquinhos,,,30.0,1994.0,19.2,30,19,8,16,6,25,33,75.8,8,27,15,12,11,41,64,0
FRA-Ligue 1,2425,Paris S-G,Matvei Safonov,,,25.0,1999.0,9.8,0,0,0,0,0,0,0,,0,1,0,1,1,1,3,0
FRA-Ligue 1,2425,Paris S-G,Milan Škriniar,,,29.0,1995.0,4.2,7,5,3,4,0,3,3,100.0,0,7,6,1,3,10,16,0
FRA-Ligue 1,2425,Paris S-G,Noham Kamara,,,17.0,2007.0,0.8,1,1,0,1,0,0,0,,0,1,1,0,1,2,1,0
FRA-Ligue 1,2425,Paris S-G,Nuno Mendes,,,22.0,2002.0,18.6,30,19,15,12,3,23,39,59.0,16,25,8,17,18,48,37,2
FRA-Ligue 1,2425,Paris S-G,Ousmane Dembélé,,,27.0,1997.0,19.2,11,5,0,7,4,4,12,33.3,8,3,0,3,9,20,2,1
FRA-Ligue 1,2425,Paris S-G,Presnel Kimpembe,,,28.0,1995.0,0.3,1,0,1,0,0,0,0,,0,2,2,0,0,1,1,0
FRA-Ligue 1,2425,Paris S-G,Randal Kolo Muani,,,25.0,1998.0,4.0,4,4,1,1,2,0,2,0.0,2,1,0,1,0,4,5,0
FRA-Ligue 1,2425,Paris S-G,Senny Mayulu,,,18.0,2006.0,9.0,25,16,8,14,3,8,14,57.1,6,8,3,5,5,30,12,0
FRA-Ligue 1,2425,Paris S-G,Vitinha,,,24.0,2000.0,22.7,43,23,13,27,3,25,48,52.1,23,26,7,19,14,57,19,2
FRA-Ligue 1,2425,Paris S-G,Warren Zaïre-Emery,,,18.0,2006.0,22.8,51,26,17,21,13,23,45,51.1,22,35,6,29,23,74,20,2
FRA-Ligue 1,2425,Paris S-G,Willian Pacho,,,22.0,2001.0,23.7,56,32,34,22,0,23,32,71.9,9,35,22,13,40,96,91,1
FRA-Ligue 1,2425,Paris S-G,Yoram Zague,,,18.0,2006.0,2.0,8,6,3,1,4,6,8,75.0,2,3,0,3,2,10,2,0
FRA-Ligue 1,2425,Reims,Abdoul Koné,,,19.0,2005.0,1.5,5,3,4,1,0,3,5,60.0,2,2,1,1,1,6,5,0
FRA-Ligue 1,2425,Reims,Amadou Koné,,,19.0,2005.0,14.4,49,32,32,16,1,22,35,62.9,13,18,4,14,19,68,38,2
FRA-Ligue 1,2425,Reims,Amine Salama,,,24.0,2000.0,4.1,3,2,0,2,1,0,3,0.0,3,2,1,1,1,4,0,0
FRA-Ligue 1,2425,Reims,Ange Martial Tia,,,17.0,2006.0,1.9,4,3,1,2,1,2,6,33.3,4,3,0,3,2,6,4,0
FRA-Ligue 1,2425,Reims,Aurélio Buta,,,27.0,1997.0,21.9,37,24,22,11,4,21,42,50.0,21,19,5,14,22,59,59,0
FRA-Ligue 1,2425,Reims,Cédric Kipré,,,27.0,1996.0,24.3,42,30,30,11,1,29,39,74.4,10,42,27,15,32,74,162,2
FRA-Ligue 1,2425,Reims,Eloge Zabi,,,17.0,2006.0,0.2,0,0,0,0,0,0,0,,0,0,0,0,0,0,1,0
FRA-Ligue 1,2425,Reims,Emmanuel Agbadou,,,27.0,1997.0,14.0,25,17,19,3,3,19,26,73.1,7,22,13,9,19,44,64,1
FRA-Ligue 1,2425,Reims,Gabriel Moscardo,,,18.0,2005.0,0.9,3,1,2,1,0,1,3,33.3,2,3,1,2,0,3,1,0
FRA-Ligue 1,2425,Reims,Hafiz Ibrahim,,,18.0,2005.0,4.3,3,2,0,1,2,0,5,0.0,5,4,2,2,2,5,6,0
FRA-Ligue 1,2425,Reims,Hiroki Sekine,,,21.0,2002.0,9.9,9,7,6,2,1,7,17,41.2,10,22,11,11,5,14,51,1
FRA-Ligue 1,2425,Reims,Ike Orazi,,,17.0,2007.0,0.0,0,0,0,0,0,0,0,,0,0,0,0,0,0,0,0
FRA-Ligue 1,2425,Reims,John Joe,,,20.0,2003.0,6.1,24,15,11,10,3,7,19,36.8,12,11,2,9,6,30,9,0
FRA-Ligue 1,2425,Reims,Jordan Pefok,,,28.0,1996.0,4.2,3,2,0,3,0,2,3,66.7,1,3,1,2,2,5,5,0
FRA-Ligue 1,2425,Reims,Joseph Okumu,,,27.0,1997.0,18.8,30,15,21,9,0,15,24,62.5,9,33,21,12,25,55,137,2
FRA-Ligue 1,2425,Reims,Junya Ito,,,31.0,1993.0,29.9,45,30,19,16,10,17,60,28.3,43,33,3,30,13,58,15,2
FRA-Ligue 1,2425,Reims,Keito Nakamura,,,24.0,2000.0,29.4,24,16,7,10,7,11,31,35.5,20,21,1,20,13,37,19,0
FRA-Ligue 1,2425,Reims,Malcolm Jeng,,,19.0,2005.0,1.2,0,0,0,0,0,0,0,,0,1,0,1,3,3,10,0
FRA-Ligue 1,2425,Reims,Mamadou Diakhon,,,18.0,2005.0,9.5,12,8,4,3,5,9,18,50.0,9,5,1,4,4,16,5,0
FRA-Ligue 1,2425,Reims,Marshall Munetsi,,,28.0,1996.0,18.8,36,18,22,9,5,22,38,57.9,16,27,3,24,17,53,35,0
FRA-Ligue 1,2425,Reims,Martin Adeline,,,20.0,2003.0,0.3,1,1,0,1,0,1,2,50.0,1,0,0,0,0,1,2,0
FRA-Ligue 1,2425,Reims,Mohamed Bamba,,,19.0,2004.0,0.1,0,0,0,0,0,0,1,0.0,1,2,1,1,0,0,1,0
FRA-Ligue 1,2425,Reims,Mohamed Daramy,,,22.0,2002.0,0.2,0,0,0,0,0,0,0,,0,0,0,0,0,0,1,0
FRA-Ligue 1,2425,Reims,Mory Gbane,,,23.0,2000.0,12.5,20,11,16,4,0,13,24,54.2,11,12,10,2,18,38,90,1
FRA-Ligue 1,2425,Reims,Nhoa Sangui,,,18.0,2006.0,12.9,16,9,6,6,4,9,12,75.0,3,8,4,4,8,24,23,0
FRA-Ligue 1,2425,Reims,Niama Sissoko,,,18.0,2005.0,0.5,0,0,0,0,0,0,0,,0,1,0,1,0,0,0,0
FRA-Ligue 1,2425,Reims,Oumar Diakité,,,20.0,2003.0,18.1,20,13,7,8,5,9,19,47.4,10,13,2,11,3,23,9,0
FRA-Ligue 1,2425,Reims,Reda Khadra,,,23.0,2001.0,0.9,1,1,1,0,0,0,1,0.0,1,0,0,0,0,1,1,0
FRA-Ligue 1,2425,Reims,Sergio Akieme,,,26.0,1997.0,28.0,34,23,30,3,1,22,36,61.1,14,26,9,17,17,51,97,4
FRA-Ligue 1,2425,Reims,Teddy Teuma,,,30.0,1993.0,8.3,18,10,6,6,6,7,25,28.0,18,12,2,10,12,30,8,1
FRA-Ligue 1,2425,Reims,Thibault De Smet,,,26.0,1998.0,2.1,6,4,5,1,0,4,4,100.0,0,5,3,2,4,10,12,0
FRA-Ligue 1,2425,Reims,Valentin Atangana Edoa,,,18.0,2005.0,31.7,69,50,32,30,7,28,38,73.7,10,31,15,16,37,106,64,0
FRA-Ligue 1,2425,Reims,Yaya Kader Fofana,,,20.0,2004.0,7.0,17,11,8,5,4,4,12,33.3,8,11,2,9,3,20,2,0
FRA-Ligue 1,2425,Reims,Yehvann Diouf,,,24.0,1999.0,34.0,2,1,2,0,0,1,3,33.3,2,0,0,0,1,3,22,4
FRA-Ligue 1,2425,Rennes,Adrien Truffert,,,22.0,2001.0,30.6,61,36,27,21,13,32,48,66.7,16,44,6,38,27,88,56,1
FRA-Ligue 1,2425,Rennes,Albert Grønbaek,,,23.0,2001.0,9.0,21,11,10,7,4,10,28,35.7,18,9,1,8,4,25,6,0
FRA-Ligue 1,2425,Rennes,Alidu Seidu,,,24.0,2000.0,8.9,22,18,14,6,2,12,15,80.0,3,13,6,7,14,36,17,0
FRA-Ligue 1,2425,Rennes,Amine Gouiri,,,24.0,2000.0,11.5,9,6,4,4,1,2,8,25.0,6,8,0,8,2,11,5,0
FRA-Ligue 1,2425,Rennes,Anthony Rouault,,,23.0,2001.0,10.8,12,8,10,2,0,4,4,100.0,0,13,11,2,8,20,65,0
FRA-Ligue 1,2425,Rennes,Arnaud Kalimuendo,,,22.0,2002.0,28.6,19,12,6,9,4,7,15,46.7,8,9,2,7,4,23,16,1
FRA-Ligue 1,2425,Rennes,Ayanda Sishuba,,,19.0,2005.0,0.0,1,0,1,0,0,1,1,100.0,0,0,0,0,0,1,0,0
FRA-Ligue 1,2425,Rennes,Azor Matusiwa,,,26.0,1998.0,23.1,64,39,32,30,2,32,43,74.4,11,29,10,19,34,98,52,0
FRA-Ligue 1,2425,Rennes,Baptiste Santamaria,,,29.0,1995.0,5.4,11,4,7,3,1,6,11,54.5,5,10,4,6,12,23,7,0
FRA-Ligue 1,2425,Rennes,Benjamin Bourigeaud,,,30.0,1994.0,0.9,1,0,0,1,0,0,2,0.0,2,2,1,1,2,3,1,0
FRA-Ligue 1,2425,Rennes,Brice Samba,,,30.0,1994.0,17.0,2,1,2,0,0,1,2,50.0,1,0,0,0,0,2,12,3
FRA-Ligue 1,2425,Rennes,Carlos Gómez,,,21.0,2002.0,4.2,8,6,3,4,1,3,9,33.3,6,6,0,6,2,10,2,0
FRA-Ligue 1,2425,Rennes,Christopher Wooh,,,22.0,2001.0,16.2,36,19,21,13,2,18,27,66.7,9,22,8,14,23,59,63,0
FRA-Ligue 1,2425,Rennes,Djaoui Cissé,,,20.0,2004.0,12.5,33,18,12,15,6,16,26,61.5,10,29,4,25,13,46,11,1
FRA-Ligue 1,2425,Rennes,Gauthier Gallon,,,31.0,1993.0,0.5,0,0,0,0,0,0,0,,0,0,0,0,0,0,0,0
FRA-Ligue 1,2425,Rennes,Glen Kamara,,,28.0,1995.0,7.4,23,11,10,11,2,11,17,64.7,6,7,0,7,7,30,7,0
FRA-Ligue 1,2425,Rennes,Hans Hateboer,,,30.0,1994.0,18.7,31,16,14,12,5,18,36,50.0,18,19,6,13,29,60,64,2
FRA-Ligue 1,2425,Rennes,Henrik Meister,,,20.0,2003.0,0.7,2,0,0,2,0,0,0,,0,4,0,4,1,3,0,0
FRA-Ligue 1,2425,Rennes,Ismaël Koné,,,22.0,2002.0,5.2,9,6,4,4,1,5,7,71.4,2,9,2,7,4,13,5,0
FRA-Ligue 1,2425,Rennes,Jordan James,,,20.0,2004.0,13.1,30,19,8,18,4,16,30,53.3,14,14,1,13,14,44,17,1
FRA-Ligue 1,2425,Rennes,Jota,,,25.0,1999.0,3.7,5,2,2,3,0,4,7,57.1,3,1,0,1,3,8,2,0
FRA-Ligue 1,2425,Rennes,Jérémy Jacquet,,,19.0,2005.0,10.3,26,17,11,8,7,14,22,63.6,8,9,3,6,27,53,45,1
FRA-Ligue 1,2425,Rennes,Kazeem Olaigbe,,,21.0,2003.0,3.3,6,4,3,3,0,3,6,50.0,3,3,1,2,0,6,0,0
FRA-Ligue 1,2425,Rennes,Kyogo Furuhashi,,,29.0,1995.0,1.4,2,2,1,1,0,1,1,100.0,0,0,0,0,0,2,0,0
FRA-Ligue 1,2425,Rennes,Leo Skiri Østigård,,,24.0,1999.0,13.6,20,18,16,4,0,15,22,68.2,7,12,10,2,15,35,81,1
FRA-Ligue 1,2425,Rennes,Lilian Brassier,,,24.0,1999.0,13.7,15,12,11,4,0,9,11,81.8,2,17,10,7,22,37,62,1
FRA-Ligue 1,2425,Rennes,Lorenz Assignon,,,24.0,2000.0,26.2,49,27,25,22,2,19,43,44.2,24,20,3,17,25,74,74,0
FRA-Ligue 1,2425,Rennes,Ludovic Blas,,,26.0,1997.0,25.5,38,25,9,12,17,23,42,54.8,19,16,2,14,13,51,11,0
FRA-Ligue 1,2425,Rennes,Mahamadou Nagida,,,19.0,2005.0,4.8,8,6,4,3,1,4,5,80.0,1,3,0,3,9,17,6,0
FRA-Ligue 1,2425,Rennes,Mikayil Ngor Faye,,,20.0,2004.0,7.6,15,12,10,3,2,7,9,77.8,2,9,4,5,12,27,30,0
FRA-Ligue 1,2425,Rennes,Mohamed Meité,,,16.0,2007.0,6.0,2,0,0,2,0,1,1,100.0,0,1,0,1,0,2,5,0
FRA-Ligue 1,2425,Rennes,Musa Al-Taamari,,,27.0,1997.0,6.3,4,1,1,1,2,0,4,0.0,4,5,0,5,2,6,2,0
FRA-Ligue 1,2425,Rennes,Naouirou Ahamada,,,22.0,2002.0,0.6,0,0,0,0,0,0,0,,0,0,0,0,2,2,2,0
FRA-Ligue 1,2425,Rennes,Seko Fofana,,,29.0,1995.0,9.4,11,7,4,6,1,2,7,28.6,5,7,1,6,7,18,7,0
FRA-Ligue 1,2425,Rennes,Steve Mandanda,,,39.0,1985.0,16.5,0,0,0,0,0,0,1,0.0,1,0,0,0,0,0,6,2
FRA-Ligue 1,2425,Saint-Étienne,Aimen Moueffek,,,23.0,2001.0,11.5,20,12,3,11,6,10,23,43.5,13,20,7,13,5,25,26,1
FRA-Ligue 1,2425,Saint-Étienne,Anthony Briançon,,,29.0,1994.0,0.0,0,0,0,0,0,0,0,,0,0,0,0,0,0,0,0
FRA-Ligue 1,2425,Saint-Étienne,Augustine Boakye,,,23.0,2000.0,8.1,7,3,3,4,0,3,11,27.3,8,5,0,5,6,13,4,0
FRA-Ligue 1,2425,Saint-Étienne,Ayman Aiki,,,19.0,2005.0,1.4,3,3,1,2,0,1,1,100.0,0,1,0,1,1,4,0,0
FRA-Ligue 1,2425,Saint-Étienne,Ben Old,,,21.0,2002.0,5.9,7,5,3,3,1,3,11,27.3,8,8,1,7,2,9,2,0
FRA-Ligue 1,2425,Saint-Étienne,Benjamin Bouchouari,,,22.0,2001.0,19.7,33,27,15,13,5,16,46,34.8,30,21,1,20,17,50,15,2
FRA-Ligue 1,2425,Saint-Étienne,Beres Owusu,,,20.0,2003.0,1.0,2,2,1,1,0,2,2,100.0,0,2,2,0,0,2,5,0
FRA-Ligue 1,2425,Saint-Étienne,Dennis Appiah,,,32.0,1992.0,23.6,71,43,42,22,7,41,71,57.7,30,36,8,28,29,100,89,2
FRA-Ligue 1,2425,Saint-Étienne,Djylian N'Guessan,,,15.0,2008.0,2.0,6,4,5,1,0,2,5,40.0,3,1,0,1,0,6,1,0
FRA-Ligue 1,2425,Saint-Étienne,Dylan Batubinsika,,,28.0,1996.0,22.4,26,13,19,6,1,13,22,59.1,9,23,14,9,39,65,140,3
FRA-Ligue 1,2425,Saint-Étienne,Florian Tardieu,,,32.0,1992.0,13.9,18,14,6,9,3,6,17,35.3,11,18,5,13,15,33,21,0
FRA-Ligue 1,2425,Saint-Étienne,Gautier Larsonneur,,,27.0,1997.0,34.0,1,0,1,0,0,0,2,0.0,2,1,0,1,0,1,25,1
FRA-Ligue 1,2425,Saint-Étienne,Ibrahim Sissoko,,,28.0,1995.0,9.1,11,9,5,3,3,2,5,40.0,3,10,2,8,2,13,13,0
FRA-Ligue 1,2425,Saint-Étienne,Ibrahima Wadji,,,29.0,1995.0,3.9,7,6,3,3,1,3,7,42.9,4,1,0,1,1,8,0,0
FRA-Ligue 1,2425,Saint-Étienne,Igor Miladinović,,,21.0,2003.0,0.3,0,0,0,0,0,0,0,,0,0,0,0,1,1,1,0
FRA-Ligue 1,2425,Saint-Étienne,Irvin Cardona,,,26.0,1997.0,11.8,6,5,3,3,0,2,14,14.3,12,16,3,13,4,10,6,2
FRA-Ligue 1,2425,Saint-Étienne,Jibril Othman,,,20.0,2004.0,0.1,0,0,0,0,0,0,0,,0,0,0,0,0,0,0,0
FRA-Ligue 1,2425,Saint-Étienne,Kévin Pedro,,,18.0,2006.0,0.1,3,0,2,1,0,3,3,100.0,0,1,0,1,2,5,1,0
FRA-Ligue 1,2425,Saint-Étienne,Lamine Fomba,,,26.0,1998.0,2.4,8,6,2,5,1,2,7,28.6,5,7,1,6,4,12,5,1
FRA-Ligue 1,2425,Saint-Étienne,Louis Mouton,,,22.0,2002.0,11.6,49,25,14,25,10,22,37,59.5,15,17,3,14,10,59,19,0
FRA-Ligue 1,2425,Saint-Étienne,Lucas Stassin,,,19.0,2004.0,21.0,16,11,3,5,8,6,20,30.0,14,10,0,10,3,19,8,0
FRA-Ligue 1,2425,Saint-Étienne,Léo Pétrot,,,27.0,1997.0,29.3,62,39,38,19,5,34,51,66.7,17,50,27,23,42,104,103,1
FRA-Ligue 1,2425,Saint-Étienne,Marwann Nzuzi,,,20.0,2004.0,1.4,2,2,1,0,1,1,2,50.0,1,0,0,0,2,4,6,0
FRA-Ligue 1,2425,Saint-Étienne,Mathieu Cafaro,,,27.0,1997.0,8.1,10,7,4,4,2,4,15,26.7,11,7,1,6,7,17,3,0
FRA-Ligue 1,2425,Saint-Étienne,Mathis Amougou,,,18.0,2006.0,9.5,21,15,15,5,1,10,19,52.6,9,10,0,10,12,33,4,0
FRA-Ligue 1,2425,Saint-Étienne,Maxime Bernauer,,,26.0,1998.0,8.5,9,9,5,2,2,5,8,62.5,3,7,3,4,5,14,44,1
FRA-Ligue 1,2425,Saint-Étienne,Mickael Nade,,,25.0,1999.0,25.6,59,43,40,19,0,28,36,77.8,8,37,19,18,33,92,132,8
FRA-Ligue 1,2425,Saint-Étienne,Pierre Cornud,,,27.0,1996.0,6.4,12,10,6,4,2,8,17,47.1,9,9,4,5,9,21,28,1
FRA-Ligue 1,2425,Saint-Étienne,Pierre Ekwah Elimby,,,22.0,2002.0,28.6,54,33,18,30,6,34,56,60.7,22,26,12,14,47,101,72,1
FRA-Ligue 1,2425,Saint-Étienne,Yunis Abdelhamid,,,36.0,1987.0,11.5,17,11,15,2,0,10,16,62.5,6,26,18,8,14,31,57,1
FRA-Ligue 1,2425,Saint-Étienne,Yvann Macon,,,25.0,1998.0,8.8,19,11,9,7,3,10,21,47.6,11,14,4,10,2,21,10,1
FRA-Ligue 1,2425,Saint-Étienne,Zuriko Davitashvili,,,23.0,2001.0,30.9,22,14,9,7,6,15,49,30.6,34,20,0,20,14,36,14,0
FRA-Ligue 1,2425,Strasbourg,Abakar Sylla,,,21.0,2002.0,10.6,27,15,14,11,2,15,17,88.2,2,18,10,8,11,38,63,0
FRA-Ligue 1,2425,Strasbourg,Andrew Omobamidele,,,22.0,2002.0,6.0,7,4,4,3,0,2,5,40.0,3,12,8,4,8,15,41,0
FRA-Ligue 1,2425,Strasbourg,Andrey Santos,,,20.0,2004.0,31.7,110,74,47,51,12,51,87,58.6,36,46,14,32,32,142,67,1
FRA-Ligue 1,2425,Strasbourg,Caleb Wiley,,,19.0,2004.0,3.0,1,0,0,1,0,0,1,0.0,1,3,1,2,4,5,5,0
FRA-Ligue 1,2425,Strasbourg,Diego Moreira,,,19.0,2004.0,28.5,44,28,17,19,8,24,50,48.0,26,23,4,19,35,79,65,0
FRA-Ligue 1,2425,Strasbourg,Dilane Bakwa,,,21.0,2002.0,27.7,26,14,11,8,7,12,24,50.0,12,21,1,20,15,41,27,0
FRA-Ligue 1,2425,Strasbourg,Eduard Sobol,,,29.0,1995.0,1.1,0,0,0,0,0,0,2,0.0,2,2,1,1,2,2,14,0
FRA-Ligue 1,2425,Strasbourg,Emanuel Emegha,,,21.0,2003.0,25.5,6,6,1,2,3,2,6,33.3,4,18,5,13,1,7,30,0
FRA-Ligue 1,2425,Strasbourg,Félix Lemaréchal,,,20.0,2003.0,19.8,35,24,13,17,5,14,29,48.3,15,35,4,31,14,49,19,0
FRA-Ligue 1,2425,Strasbourg,Guela Doué,,,21.0,2002.0,30.2,65,45,40,15,10,37,54,68.5,17,38,6,32,34,99,154,1
FRA-Ligue 1,2425,Strasbourg,Guimissongui Ouattara,,,18.0,2005.0,5.2,6,4,3,1,2,3,5,60.0,2,10,0,10,9,15,12,2
FRA-Ligue 1,2425,Strasbourg,Habib Diarra,,,20.0,2004.0,26.1,22,13,6,13,3,8,20,40.0,12,22,6,16,13,35,46,3
FRA-Ligue 1,2425,Strasbourg,Ismaël Doukouré,,,21.0,2003.0,29.3,40,22,19,18,3,17,25,68.0,8,31,14,17,25,65,102,3
FRA-Ligue 1,2425,Strasbourg,Junior Mwanga,,,21.0,2003.0,3.3,17,9,9,7,1,5,9,55.6,4,2,0,2,2,19,2,0
FRA-Ligue 1,2425,Strasbourg,Jérémy Sebas,,,21.0,2003.0,2.1,3,2,1,1,1,2,3,66.7,1,2,0,2,0,3,4,0
FRA-Ligue 1,2425,Strasbourg,Karl-Johan Johnsson,,,34.0,1990.0,3.0,0,0,0,0,0,0,1,0.0,1,0,0,0,0,0,3,0
FRA-Ligue 1,2425,Strasbourg,Karol Fila,,,26.0,1998.0,0.1,0,0,0,0,0,0,0,,0,0,0,0,0,0,0,0
FRA-Ligue 1,2425,Strasbourg,Mamadou Sarr,,,18.0,2005.0,26.3,37,21,24,11,2,16,24,66.7,8,26,20,6,25,62,117,3
FRA-Ligue 1,2425,Strasbourg,Marvin Senaya,,,23.0,2001.0,2.5,8,3,5,2,1,6,12,50.0,6,6,2,4,7,15,12,0
FRA-Ligue 1,2425,Strasbourg,Milos Lukovic,,,18.0,2005.0,0.1,0,0,0,0,0,0,0,,0,0,0,0,0,0,0,0
FRA-Ligue 1,2425,Strasbourg,Nordine Kandil,,,22.0,2001.0,0.1,0,0,0,0,0,0,0,,0,0,0,0,0,0,1,0
FRA-Ligue 1,2425,Strasbourg,Pape Daouda Diongue,,,,,0.9,2,0,1,1,0,1,2,50.0,1,0,0,0,3,5,2,0
FRA-Ligue 1,2425,Strasbourg,Saidou Sow,,,22.0,2002.0,11.3,9,5,6,3,0,6,12,50.0,6,15,9,6,15,24,37,2
FRA-Ligue 1,2425,Strasbourg,Samuel Amo-Ameyaw,,,18.0,2006.0,3.6,5,3,3,2,0,2,9,22.2,7,3,0,3,3,8,2,0
FRA-Ligue 1,2425,Strasbourg,Sebastian Nanasi,,,22.0,2002.0,23.4,20,13,6,12,2,8,22,36.4,14,24,3,21,7,27,18,0
FRA-Ligue 1,2425,Strasbourg,Sekou Mara,,,22.0,2002.0,8.5,9,6,0,5,4,3,9,33.3,6,11,0,11,3,12,3,0
FRA-Ligue 1,2425,Strasbourg,Thomas Delaine,,,32.0,1992.0,0.1,1,1,1,0,0,1,1,100.0,0,0,0,0,1,2,1,0
FRA-Ligue 1,2425,Strasbourg,Valentín Barco,,,20.0,2004.0,12.9,36,22,24,10,2,22,30,73.3,8,8,3,5,13,49,28,1
FRA-Ligue 1,2425,Strasbourg,Óscar Perea,,,18.0,2005.0,0.2,0,0,0,0,0,0,0,,0,0,0,0,0,0,0,0
FRA-Ligue 1,2425,Strasbourg,Đorđe Petrović,,,24.0,1999.0,31.0,1,1,1,0,0,0,0,,0,0,0,0,0,1,24,1
FRA-Ligue 1,2425,Toulouse,Aron Dønnum,,,26.0,1998.0,29.9,56,35,25,24,7,31,55,56.4,24,29,4,25,28,84,37,1
FRA-Ligue 1,2425,Toulouse,Charlie Cresswell,,,21.0,2002.0,28.8,35,23,19,15,1,28,46,60.9,18,44,28,16,28,63,191,3
FRA-Ligue 1,2425,Toulouse,Cristian Cásseres Jr.,,,24.0,2000.0,30.0,96,61,41,43,12,46,88,52.3,42,35,9,26,42,138,36,1
FRA-Ligue 1,2425,Toulouse,Denis Genreau,,,25.0,1999.0,2.5,7,5,4,1,2,4,8,50.0,4,3,0,3,3,10,4,0
FRA-Ligue 1,2425,Toulouse,Djibril Sidibé,,,32.0,1992.0,23.3,65,36,34,22,9,31,50,62.0,19,11,3,8,20,85,64,1
FRA-Ligue 1,2425,Toulouse,Edhy Zuliani,,,19.0,2004.0,0.1,0,0,0,0,0,0,0,,0,0,0,0,1,1,0,0
FRA-Ligue 1,2425,Toulouse,Frank Magri,,,24.0,1999.0,16.8,8,2,1,6,1,3,8,37.5,5,16,2,14,4,12,11,0
FRA-Ligue 1,2425,Toulouse,Gabriel Suazo,,,26.0,1997.0,24.0,59,39,25,22,12,30,72,41.7,42,27,3,24,36,95,40,1
FRA-Ligue 1,2425,Toulouse,Guillaume Restes,,,19.0,2005.0,28.3,2,1,2,0,0,2,3,66.7,1,0,0,0,1,3,16,1
FRA-Ligue 1,2425,Toulouse,Jaydee Canvot,,,18.0,2006.0,12.3,23,11,16,5,2,12,18,66.7,6,10,2,8,11,34,54,1
FRA-Ligue 1,2425,Toulouse,Joshua King,,,32.0,1992.0,18.6,11,11,4,4,3,5,12,41.7,7,10,3,7,6,17,19,0
FRA-Ligue 1,2425,Toulouse,Kjetil Haug,,,26.0,1998.0,5.5,0,0,0,0,0,0,0,,0,0,0,0,0,0,3,0
FRA-Ligue 1,2425,Toulouse,Logan Costa,,,23.0,2001.0,1.0,2,1,0,2,0,1,1,100.0,0,2,2,0,2,4,4,0
FRA-Ligue 1,2425,Toulouse,Mark McKenzie,,,25.0,1999.0,27.7,52,31,31,20,1,33,45,73.3,12,31,18,13,22,74,141,1
FRA-Ligue 1,2425,Toulouse,Miha Zajc,,,30.0,1994.0,2.9,4,4,1,2,1,3,5,60.0,2,2,1,1,3,7,7,0
FRA-Ligue 1,2425,Toulouse,Naatan Skyttä,,,22.0,2002.0,0.1,1,0,0,0,1,0,0,,0,0,0,0,0,1,0,0
FRA-Ligue 1,2425,Toulouse,Niklas Schmidt,,,26.0,1998.0,2.3,6,4,1,5,0,4,7,57.1,3,0,0,0,1,7,4,0
FRA-Ligue 1,2425,Toulouse,Noah Edjouma,,,18.0,2005.0,1.9,2,2,0,1,1,1,2,50.0,1,1,1,0,2,4,2,0
FRA-Ligue 1,2425,Toulouse,Rafik Messali,,,21.0,2003.0,5.1,15,8,6,6,3,7,8,87.5,1,9,1,8,10,25,12,0
FRA-Ligue 1,2425,Toulouse,Rasmus Nicolaisen,,,27.0,1997.0,6.9,6,3,4,2,0,3,5,60.0,2,10,5,5,10,16,25,0
FRA-Ligue 1,2425,Toulouse,Shavy Babicka,,,24.0,2000.0,13.2,21,12,6,11,4,10,21,47.6,11,14,0,14,3,24,4,3
FRA-Ligue 1,2425,Toulouse,Vincent Sierro,,,28.0,1995.0,26.7,44,27,15,23,6,27,56,48.2,29,34,9,25,16,60,44,1
FRA-Ligue 1,2425,Toulouse,Warren Kamanzi,,,23.0,2000.0,11.4,29,13,12,12,5,14,28,50.0,14,7,3,4,9,38,25,0
FRA-Ligue 1,2425,Toulouse,Yann Gboho,,,23.0,2001.0,25.9,31,18,7,15,9,14,35,40.0,21,20,0,20,6,37,4,1
FRA-Ligue 1,2425,Toulouse,Zakaria Aboukhlal,,,24.0,2000.0,21.1,22,13,7,8,7,4,23,17.4,19,16,1,15,6,28,9,0
FRA-Ligue 1,2425,Toulouse,Álex Domínguez,,,26.0,1998.0,0.2,0,0,0,0,0,0,0,,0,0,0,0,0,0,0,0
FRA-Ligue 1,2425,Toulouse,Ümit Akdag,,,20.0,2003.0,5.6,8,4,3,4,1,5,12,41.7,7,10,8,2,11,19,19,0
GER-Bundesliga,2425,Augsburg,Alexis Claude-Maurice,,,26.0,1998.0,23.4,41,26,12,15,14,17,34,50.0,17,16,0,16,15,56,8,1
GER-Bundesliga,2425,Augsburg,Arne Engels,,,20.0,2003.0,0.9,0,0,0,0,0,0,0,,0,1,1,0,0,0,0,0
GER-Bundesliga,2425,Augsburg,Arne Maier,,,25.0,1999.0,10.4,13,7,4,8,1,7,13,53.8,6,15,1,14,6,19,14,1
GER-Bundesliga,2425,Augsburg,Cedric Zesiger,,,26.0,1998.0,13.6,13,7,7,6,0,8,13,61.5,5,17,10,7,21,34,96,1
GER-Bundesliga,2425,Augsburg,Chrislain Matsima,,,22.0,2002.0,28.3,31,20,19,11,1,17,26,65.4,9,48,29,19,52,83,163,0
GER-Bundesliga,2425,Augsburg,Dimitris Giannoulis,,,28.0,1995.0,29.4,47,32,27,16,4,26,44,59.1,18,49,11,38,47,94,75,0
GER-Bundesliga,2425,Augsburg,Elvis Rexhbeçaj,,,26.0,1997.0,19.8,27,19,9,14,4,15,35,42.9,20,40,9,31,16,43,22,1
GER-Bundesliga,2425,Augsburg,Finn Dahmen,,,26.0,1998.0,19.0,1,0,1,0,0,1,2,50.0,1,0,0,0,0,1,9,0
GER-Bundesliga,2425,Augsburg,Frank Onyeka,,,26.0,1998.0,28.7,58,45,22,28,8,22,40,55.0,18,36,9,27,36,94,36,2
GER-Bundesliga,2425,Augsburg,Fredrik Jensen,,,26.0,1997.0,8.5,7,7,1,3,3,4,5,80.0,1,10,1,9,4,11,17,0
GER-Bundesliga,2425,Augsburg,Henri Koudossou,,,24.0,1999.0,8.3,18,10,6,11,1,11,19,57.9,8,8,2,6,15,33,37,0
GER-Bundesliga,2425,Augsburg,Jeffrey Gouweleeuw,,,33.0,1991.0,32.7,50,28,25,21,4,27,40,67.5,13,34,15,19,35,85,183,0
GER-Bundesliga,2425,Augsburg,Keven Schlotterbeck,,,27.0,1997.0,14.4,19,17,9,9,1,12,16,75.0,4,13,6,7,15,34,73,1
GER-Bundesliga,2425,Augsburg,Kristijan Jakić,,,27.0,1997.0,25.6,46,23,20,19,7,22,43,51.2,21,42,9,33,28,74,50,1
GER-Bundesliga,2425,Augsburg,Mads Pedersen,,,27.0,1996.0,2.6,8,7,5,2,1,4,5,80.0,1,4,0,4,2,10,6,0
GER-Bundesliga,2425,Augsburg,Marius Wolf,,,29.0,1995.0,23.8,27,16,13,11,3,16,43,37.2,27,29,5,24,24,51,51,1
GER-Bundesliga,2425,Augsburg,Maximilian Bauer,,,24.0,2000.0,7.3,14,8,5,7,2,9,14,64.3,5,10,4,6,6,20,35,1
GER-Bundesliga,2425,Augsburg,Mergim Berisha,,,26.0,1998.0,0.4,1,0,0,1,0,1,1,100.0,0,2,1,1,0,1,0,0
GER-Bundesliga,2425,Augsburg,Mert Kömür,,,19.0,2005.0,7.3,3,2,2,0,1,0,3,0.0,3,9,3,6,3,6,7,1
GER-Bundesliga,2425,Augsburg,Nediljko Labrović,,,24.0,1999.0,15.0,0,0,0,0,0,0,0,,0,0,0,0,0,0,12,1
GER-Bundesliga,2425,Augsburg,Niklas Dorsch,,,26.0,1998.0,0.4,0,0,0,0,0,0,0,,0,1,0,1,0,0,0,0
GER-Bundesliga,2425,Augsburg,Noahkai Banks,,,17.0,2006.0,3.1,11,5,6,4,1,3,7,42.9,4,4,1,3,5,16,28,0
GER-Bundesliga,2425,Augsburg,Phillip Tietz,,,27.0,1997.0,18.7,11,6,2,7,2,5,8,62.5,3,10,1,9,5,16,26,1
GER-Bundesliga,2425,Augsburg,Robert Gumny,,,26.0,1998.0,3.0,3,3,1,2,0,2,6,33.3,4,2,0,2,1,4,6,0
GER-Bundesliga,2425,Augsburg,Ruben Vargas,,,25.0,1998.0,3.4,2,1,1,1,0,1,4,25.0,3,1,0,1,2,4,1,1
GER-Bundesliga,2425,Augsburg,Samuel Essende,,,26.0,1998.0,18.2,7,6,1,3,3,3,4,75.0,1,13,2,11,0,7,11,1
GER-Bundesliga,2425,Augsburg,Steve Mounié,,,29.0,1994.0,3.9,4,4,0,1,3,0,1,0.0,1,1,1,0,1,5,5,1
GER-Bundesliga,2425,Augsburg,Tim Breithaupt,,,22.0,2002.0,1.3,1,1,0,1,0,0,4,0.0,4,1,0,1,2,3,0,0
GER-Bundesliga,2425,Augsburg,Yusuf Kabadayı,,,20.0,2004.0,0.8,1,0,0,1,0,0,0,,0,1,0,1,0,1,0,0
GER-Bundesliga,2425,Bayern Munich,Adam Aznou,,,18.0,2006.0,0.2,0,0,0,0,0,0,0,,0,0,0,0,0,0,1,0
GER-Bundesliga,2425,Bayern Munich,Aleksandar Pavlovic,,,20.0,2004.0,16.1,38,21,13,15,10,22,32,68.8,10,18,3,15,5,43,14,0
GER-Bundesliga,2425,Bayern Munich,Alphonso Davies,,,23.0,2000.0,17.3,30,17,7,17,6,17,26,65.4,9,14,1,13,13,43,22,2
GER-Bundesliga,2425,Bayern Munich,Arijon Ibrahimović,,,18.0,2005.0,0.0,0,0,0,0,0,0,0,,0,0,0,0,0,0,0,0
GER-Bundesliga,2425,Bayern Munich,Daniel Peretz,,,24.0,2000.0,3.0,0,0,0,0,0,0,1,0.0,1,0,0,0,0,0,2,0
GER-Bundesliga,2425,Bayern Munich,Dayot Upamecano,,,25.0,1998.0,19.5,36,22,18,16,2,16,29,55.2,13,17,7,10,34,70,45,1
GER-Bundesliga,2425,Bayern Munich,Eric Dier,,,30.0,1994.0,16.3,19,11,8,9,2,13,20,65.0,7,19,8,11,20,39,77,1
GER-Bundesliga,2425,Bayern Munich,Gabriel Vidovic,,,20.0,2003.0,0.3,0,0,0,0,0,0,0,,0,2,0,2,0,0,0,0
GER-Bundesliga,2425,Bayern Munich,Harry Kane,,,31.0,1993.0,26.5,13,11,3,8,2,2,6,33.3,4,16,2,14,2,15,16,0
GER-Bundesliga,2425,Bayern Munich,Hiroki Ito,,,25.0,1999.0,2.8,2,0,1,1,0,1,1,100.0,0,3,2,1,6,8,15,1
GER-Bundesliga,2425,Bayern Munich,Jamal Musiala,,,21.0,2003.0,20.0,36,21,7,16,13,12,29,41.4,17,30,0,30,8,44,5,1
GER-Bundesliga,2425,Bayern Munich,Jonah Kusi-Asare,,,17.0,2007.0,0.0,1,0,0,0,1,0,0,,0,0,0,0,0,1,0,0
GER-Bundesliga,2425,Bayern Munich,Jonas Urbig,,,20.0,2003.0,8.0,0,0,0,0,0,0,0,,0,0,0,0,0,0,9,2
GER-Bundesliga,2425,Bayern Munich,Joshua Kimmich,,,29.0,1995.0,31.6,47,29,11,29,7,30,50,60.0,20,23,3,20,25,72,34,3
GER-Bundesliga,2425,Bayern Munich,Josip Stanišić,,,24.0,2000.0,9.7,13,11,6,4,3,7,15,46.7,8,10,6,4,6,19,29,1
GER-Bundesliga,2425,Bayern Munich,João Palhinha,,,29.0,1995.0,7.5,20,14,6,11,3,11,16,68.8,5,13,1,12,4,24,9,1
GER-Bundesliga,2425,Bayern Munich,Kim Min-jae,,,27.0,1996.0,25.4,35,20,18,13,4,11,21,52.4,10,23,10,13,37,72,91,4
GER-Bundesliga,2425,Bayern Munich,Kingsley Coman,,,28.0,1996.0,14.2,17,12,6,6,5,8,12,66.7,4,12,0,12,8,25,15,0
GER-Bundesliga,2425,Bayern Munich,Konrad Laimer,,,27.0,1997.0,18.9,49,27,19,22,8,23,48,47.9,25,24,1,23,8,57,24,1
GER-Bundesliga,2425,Bayern Munich,Leon Goretzka,,,29.0,1995.0,14.7,21,11,5,12,4,10,20,50.0,10,27,7,20,20,41,25,1
GER-Bundesliga,2425,Bayern Munich,Leroy Sané,,,28.0,1996.0,18.2,23,15,4,8,11,12,23,52.2,11,8,0,8,7,30,3,0
GER-Bundesliga,2425,Bayern Munich,Manuel Neuer,,,38.0,1986.0,22.0,1,0,1,0,0,1,1,100.0,0,0,0,0,0,1,9,1
GER-Bundesliga,2425,Bayern Munich,Mathys Tel,,,19.0,2005.0,2.8,2,2,0,2,0,0,0,,0,0,0,0,1,3,1,0
GER-Bundesliga,2425,Bayern Munich,Michael Olise,,,22.0,2001.0,25.9,36,23,10,21,5,17,38,44.7,21,23,1,22,8,44,16,2
GER-Bundesliga,2425,Bayern Munich,Raphaël Guerreiro,,,30.0,1993.0,17.5,19,12,9,7,3,12,16,75.0,4,9,0,9,10,29,19,1
GER-Bundesliga,2425,Bayern Munich,Sacha Boey,,,23.0,2000.0,6.6,20,5,6,6,8,13,18,72.2,5,6,0,6,2,22,14,0
GER-Bundesliga,2425,Bayern Munich,Serge Gnabry,,,29.0,1995.0,13.8,20,11,6,7,7,8,12,66.7,4,11,0,11,6,26,9,0
GER-Bundesliga,2425,Bayern Munich,Sven Ulreich,,,35.0,1988.0,1.0,0,0,0,0,0,0,0,,0,0,0,0,0,0,0,0
GER-Bundesliga,2425,Bayern Munich,Thomas Müller,,,34.0,1989.0,13.6,8,5,2,3,3,4,16,25.0,12,10,0,10,2,10,14,0
GER-Bundesliga,2425,Bochum,Aliou Badara Baldé,,,21.0,2002.0,1.0,1,1,1,0,0,0,0,,0,2,0,2,0,1,0,0
GER-Bundesliga,2425,Bochum,Anthony Losilla,,,38.0,1986.0,12.6,30,16,15,12,3,17,33,51.5,16,22,7,15,18,48,27,1
GER-Bundesliga,2425,Bochum,Bernardo,,,29.0,1995.0,19.8,46,28,32,13,1,27,37,73.0,10,38,17,21,26,72,103,4
GER-Bundesliga,2425,Bochum,Cristian Gamboa,,,34.0,1989.0,2.5,8,3,5,3,0,3,9,33.3,6,2,0,2,2,10,8,0
GER-Bundesliga,2425,Bochum,Dani de Wit,,,26.0,1998.0,12.8,29,17,11,15,3,18,31,58.1,13,17,4,13,12,41,23,1
GER-Bundesliga,2425,Bochum,Erhan Mašović,,,25.0,1998.0,10.1,14,10,10,4,0,13,28,46.4,15,17,11,6,12,26,55,0
GER-Bundesliga,2425,Bochum,Felix Passlack,,,26.0,1998.0,25.9,53,23,32,13,8,30,55,54.5,25,42,11,31,18,71,63,1
GER-Bundesliga,2425,Bochum,Gerrit Holtmann,,,29.0,1995.0,12.6,24,19,14,8,2,12,24,50.0,12,18,5,13,16,40,15,0
GER-Bundesliga,2425,Bochum,Giorgos Masouras,,,30.0,1994.0,11.7,18,10,6,7,5,7,16,43.8,9,9,1,8,4,22,3,1
GER-Bundesliga,2425,Bochum,Ibrahima Sissoko,,,26.0,1997.0,29.0,66,44,30,31,5,24,45,53.3,21,39,11,28,36,102,61,0
GER-Bundesliga,2425,Bochum,Ivan Ordets,,,32.0,1992.0,20.7,18,8,13,5,0,10,13,76.9,3,29,16,13,41,59,139,3
GER-Bundesliga,2425,Bochum,Jakov Medić,,,25.0,1998.0,17.8,13,11,9,3,1,8,18,44.4,10,32,21,11,22,35,111,4
GER-Bundesliga,2425,Bochum,Kacper Koscierski,,,17.0,2007.0,0.1,0,0,0,0,0,0,0,,0,0,0,0,0,0,0,0
GER-Bundesliga,2425,Bochum,Koji Miyoshi,,,27.0,1997.0,5.2,8,5,2,1,5,4,9,44.4,5,10,1,9,2,10,2,0
GER-Bundesliga,2425,Bochum,Lukas Daschner,,,25.0,1998.0,4.6,4,2,1,2,1,2,9,22.2,7,5,0,5,0,4,5,0
GER-Bundesliga,2425,Bochum,Mats Pannewig,,,19.0,2004.0,3.0,10,6,7,3,0,3,12,25.0,9,8,1,7,2,12,8,0
GER-Bundesliga,2425,Bochum,Matúš Bero,,,28.0,1995.0,28.5,65,35,33,21,11,29,60,48.3,31,37,9,28,17,82,35,1
GER-Bundesliga,2425,Bochum,Maximilian Wittek,,,28.0,1995.0,30.1,65,42,40,19,6,38,54,70.4,16,54,8,46,27,92,89,3
GER-Bundesliga,2425,Bochum,Moritz Broschinski,,,23.0,2000.0,15.4,19,14,6,6,7,6,15,40.0,9,18,0,18,1,20,18,0
GER-Bundesliga,2425,Bochum,Moritz-Broni Kwarteng,,,26.0,1998.0,1.9,4,3,1,1,2,1,2,50.0,1,0,0,0,0,4,1,0
GER-Bundesliga,2425,Bochum,Myron Boadu,,,23.0,2001.0,11.6,2,1,0,0,2,1,5,20.0,4,3,0,3,1,3,4,0
GER-Bundesliga,2425,Bochum,Patrick Drewes,,,31.0,1993.0,21.0,0,0,0,0,0,0,1,0.0,1,1,0,1,0,0,11,1
GER-Bundesliga,2425,Bochum,Philipp Hofmann,,,31.0,1993.0,25.3,17,12,4,6,7,8,15,53.3,7,14,1,13,4,21,33,0
GER-Bundesliga,2425,Bochum,Samuel Bamba,,,20.0,2004.0,0.3,1,1,1,0,0,0,0,,0,0,0,0,0,1,0,0
GER-Bundesliga,2425,Bochum,Tim Oermann,,,20.0,2003.0,24.6,50,31,25,21,4,26,43,60.5,17,32,16,16,22,72,64,0
GER-Bundesliga,2425,Bochum,Timo Horn,,,31.0,1993.0,13.0,0,0,0,0,0,0,0,,0,0,0,0,0,0,9,2
GER-Bundesliga,2425,Bochum,Tom Krauß,,,23.0,2001.0,12.0,35,18,20,13,2,19,38,50.0,19,26,2,24,11,46,19,1
GER-Bundesliga,2425,Dortmund,Alexander Meyer,,,33.0,1991.0,2.0,0,0,0,0,0,0,0,,0,0,0,0,0,0,0,0
GER-Bundesliga,2425,Dortmund,Almugera Kabar,,,18.0,2006.0,1.5,5,3,2,2,1,3,3,100.0,0,1,0,1,1,6,4,0
GER-Bundesliga,2425,Dortmund,Ayman Azhil,,,23.0,2001.0,0.3,1,1,1,0,0,0,0,,0,0,0,0,0,1,0,0
GER-Bundesliga,2425,Dortmund,Carney Chukwuemeka,,,20.0,2003.0,2.8,7,5,3,2,2,1,1,100.0,0,5,0,5,1,8,1,0
GER-Bundesliga,2425,Dortmund,Cole Campbell,,,18.0,2006.0,0.2,0,0,0,0,0,0,0,,0,0,0,0,0,0,1,0
GER-Bundesliga,2425,Dortmund,Daniel Svensson,,,22.0,2002.0,8.7,15,11,5,6,4,7,11,63.6,4,10,4,6,5,20,30,0
GER-Bundesliga,2425,Dortmund,Donyell Malen,,,25.0,1999.0,6.8,0,0,0,0,0,0,2,0.0,2,2,0,2,3,3,6,0
GER-Bundesliga,2425,Dortmund,Emre Can,,,30.0,1994.0,23.4,50,28,30,16,4,18,36,50.0,18,31,17,14,20,70,89,3
GER-Bundesliga,2425,Dortmund,Felix Nmecha,,,23.0,2000.0,16.8,34,22,6,19,9,12,22,54.5,10,20,5,15,23,57,30,1
GER-Bundesliga,2425,Dortmund,Gio Reyna,,,21.0,2002.0,3.9,7,0,3,0,4,4,5,80.0,1,3,1,2,0,7,9,0
GER-Bundesliga,2425,Dortmund,Gregor Kobel,,,26.0,1997.0,32.0,0,0,0,0,0,0,0,,0,0,0,0,1,1,23,3
GER-Bundesliga,2425,Dortmund,Jamie Gittens,,,19.0,2004.0,19.7,31,19,12,12,7,14,18,77.8,4,16,0,16,10,41,4,0
GER-Bundesliga,2425,Dortmund,Julian Brandt,,,28.0,1996.0,25.6,26,11,13,8,5,15,43,34.9,28,17,0,17,14,40,13,1
GER-Bundesliga,2425,Dortmund,Julian Ryerson,,,26.0,1997.0,25.1,46,30,26,13,7,25,44,56.8,19,29,2,27,22,68,26,1
GER-Bundesliga,2425,Dortmund,Julien Duranville,,,18.0,2006.0,3.1,3,0,0,3,0,1,2,50.0,1,1,0,1,0,3,3,0
GER-Bundesliga,2425,Dortmund,Karim Adeyemi,,,22.0,2002.0,15.9,20,14,6,6,8,8,20,40.0,12,14,1,13,7,27,5,0
GER-Bundesliga,2425,Dortmund,Kjell-Arik Wätjen,,,18.0,2006.0,0.2,0,0,0,0,0,0,0,,0,0,0,0,0,0,2,0
GER-Bundesliga,2425,Dortmund,Marcel Sabitzer,,,30.0,1994.0,18.0,29,19,7,15,7,16,27,59.3,11,19,6,13,10,39,29,1
GER-Bundesliga,2425,Dortmund,Maximilian Beier,,,21.0,2002.0,17.7,25,16,8,11,6,12,31,38.7,19,15,1,14,7,32,14,1
GER-Bundesliga,2425,Dortmund,Nico Schlotterbeck,,,24.0,1999.0,22.0,38,24,21,16,1,27,45,60.0,18,31,15,16,22,60,79,1
GER-Bundesliga,2425,Dortmund,Niklas Süle,,,28.0,1995.0,11.7,14,12,9,5,0,10,14,71.4,4,11,6,5,4,18,46,1
GER-Bundesliga,2425,Dortmund,Pascal Groß,,,33.0,1991.0,25.9,44,28,11,26,7,15,51,29.4,36,46,13,33,9,53,30,1
GER-Bundesliga,2425,Dortmund,Ramy Bensebaini,,,29.0,1995.0,22.5,51,25,25,18,8,33,51,64.7,18,42,9,33,33,84,86,1
GER-Bundesliga,2425,Dortmund,Salih Özcan,,,26.0,1998.0,4.3,11,7,6,4,1,7,13,53.8,6,7,0,7,11,22,10,0
GER-Bundesliga,2425,Dortmund,Serhou Guirassy,,,28.0,1996.0,28.9,7,6,2,2,3,2,5,40.0,3,10,3,7,4,11,38,0
GER-Bundesliga,2425,Dortmund,Waldemar Anton,,,28.0,1996.0,21.7,34,21,18,10,6,17,23,73.9,6,33,16,17,30,64,112,1
GER-Bundesliga,2425,Dortmund,Yan Couto,,,22.0,2002.0,9.9,24,16,17,2,5,14,25,56.0,11,12,1,11,10,34,32,2
GER-Bundesliga,2425,Dortmund,Yannik Lührs,,,20.0,2003.0,1.4,1,1,1,0,0,0,0,,0,0,0,0,2,3,4,0
GER-Bundesliga,2425,Eint Frankfurt,Ansgar Knauff,,,22.0,2002.0,17.7,41,22,18,16,7,12,26,46.2,14,23,4,19,12,53,24,0
GER-Bundesliga,2425,Eint Frankfurt,Arthur Theate,,,24.0,2000.0,30.0,36,25,19,16,1,22,44,50.0,22,42,19,23,39,75,170,3
GER-Bundesliga,2425,Eint Frankfurt,Aurele Amenda,,,21.0,2003.0,1.1,1,0,1,0,0,0,0,,0,2,2,0,2,3,11,0
GER-Bundesliga,2425,Eint Frankfurt,Can Uzun,,,18.0,2005.0,7.5,10,4,1,4,5,5,10,50.0,5,9,0,9,1,11,3,0
GER-Bundesliga,2425,Eint Frankfurt,Ellyes Skhiri,,,29.0,1995.0,24.8,40,22,15,21,4,18,44,40.9,26,30,7,23,31,71,45,4
GER-Bundesliga,2425,Eint Frankfurt,Elye Wahi,,,21.0,2003.0,2.2,0,0,0,0,0,0,1,0.0,1,1,0,1,0,0,1,0
GER-Bundesliga,2425,Eint Frankfurt,Fares Chaïbi,,,21.0,2002.0,11.3,13,9,4,5,4,7,20,35.0,13,10,0,10,10,23,32,1
GER-Bundesliga,2425,Eint Frankfurt,Hugo Ekitike,,,22.0,2002.0,28.5,16,12,3,8,5,4,12,33.3,8,13,1,12,7,23,24,0
GER-Bundesliga,2425,Eint Frankfurt,Hugo Larsson,,,20.0,2004.0,26.6,47,27,17,25,5,21,42,50.0,21,42,11,31,30,77,35,1
GER-Bundesliga,2425,Eint Frankfurt,Igor Matanovic,,,21.0,2003.0,3.5,2,0,0,2,0,0,1,0.0,1,3,0,3,1,3,9,0
GER-Bundesliga,2425,Eint Frankfurt,Jean Mattéo Bahoya,,,19.0,2005.0,10.2,29,18,11,13,5,16,26,61.5,10,14,2,12,4,33,10,1
GER-Bundesliga,2425,Eint Frankfurt,Junior Dina Ebimbe,,,23.0,2000.0,3.3,3,2,1,2,0,1,3,33.3,2,4,0,4,7,10,6,0
GER-Bundesliga,2425,Eint Frankfurt,Kauã Santos,,,21.0,2003.0,8.5,0,0,0,0,0,0,0,,0,0,0,0,0,0,10,2
GER-Bundesliga,2425,Eint Frankfurt,Kevin Trapp,,,34.0,1990.0,25.5,0,0,0,0,0,0,0,,0,0,0,0,0,0,13,3
GER-Bundesliga,2425,Eint Frankfurt,Mahmoud Dahoud,,,28.0,1996.0,4.0,9,4,4,5,0,4,6,66.7,2,5,1,4,2,11,5,0
GER-Bundesliga,2425,Eint Frankfurt,Mario Götze,,,32.0,1992.0,17.1,41,28,18,20,3,15,36,41.7,21,15,1,14,7,48,8,0
GER-Bundesliga,2425,Eint Frankfurt,Michy Batshuayi,,,30.0,1993.0,3.3,1,1,1,0,0,1,1,100.0,0,2,0,2,1,2,0,0
GER-Bundesliga,2425,Eint Frankfurt,Nathaniel Brown,,,21.0,2003.0,21.6,71,42,39,18,14,44,55,80.0,11,30,0,30,15,86,55,1
GER-Bundesliga,2425,Eint Frankfurt,Niels Nkounkou,,,23.0,2000.0,4.2,13,10,7,3,3,4,7,57.1,3,5,2,3,7,20,15,0
GER-Bundesliga,2425,Eint Frankfurt,Nnamdi Collins,,,20.0,2004.0,16.5,33,24,24,7,2,17,22,77.3,5,22,11,11,16,49,74,3
GER-Bundesliga,2425,Eint Frankfurt,Omar Marmoush,,,25.0,1999.0,16.1,12,8,0,3,9,3,7,42.9,4,7,1,6,2,14,2,0
GER-Bundesliga,2425,Eint Frankfurt,Oscar Højlund,,,19.0,2005.0,8.0,21,12,8,9,4,8,16,50.0,8,15,7,8,5,26,11,1
GER-Bundesliga,2425,Eint Frankfurt,Rasmus Kristensen,,,27.0,1997.0,27.9,59,33,37,17,5,40,67,59.7,27,50,13,37,20,79,97,1
GER-Bundesliga,2425,Eint Frankfurt,Robin Koch,,,28.0,1996.0,28.7,24,11,14,8,2,10,22,45.5,12,39,25,14,25,49,197,4
GER-Bundesliga,2425,Eint Frankfurt,Timothy Chandler,,,34.0,1990.0,0.3,0,0,0,0,0,0,0,,0,0,0,0,3,3,2,0
GER-Bundesliga,2425,Eint Frankfurt,Tuta,,,25.0,1999.0,25.3,44,27,25,17,2,28,40,70.0,12,42,21,21,40,84,135,1
GER-Bundesliga,2425,Freiburg,Christian Günter,,,31.0,1993.0,25.7,23,21,12,8,3,16,29,55.2,13,24,10,14,8,31,50,1
GER-Bundesliga,2425,Freiburg,Eren Dinkçi,,,22.0,2001.0,13.3,21,13,8,8,5,7,23,30.4,16,22,2,20,7,28,7,0
GER-Bundesliga,2425,Freiburg,Florent Muslija,,,26.0,1998.0,1.9,5,4,3,1,1,2,2,100.0,0,0,0,0,1,6,1,0
GER-Bundesliga,2425,Freiburg,Florian Müller,,,26.0,1997.0,8.4,0,0,0,0,0,0,0,,0,0,0,0,0,0,3,0
GER-Bundesliga,2425,Freiburg,Ifechukwu Ogbus,,,18.0,2005.0,0.2,1,1,0,0,1,0,1,0.0,1,0,0,0,1,2,2,0
GER-Bundesliga,2425,Freiburg,Jan-Niklas Beste,,,25.0,1999.0,2.4,2,1,0,1,1,1,7,14.3,6,3,0,3,1,3,7,0
GER-Bundesliga,2425,Freiburg,Johan Manzambi,,,18.0,2005.0,3.7,8,2,1,3,4,1,4,25.0,3,6,0,6,4,12,7,0
GER-Bundesliga,2425,Freiburg,Jordy Makengo,,,22.0,2001.0,8.3,16,9,10,5,1,10,16,62.5,6,8,3,5,7,23,29,0
GER-Bundesliga,2425,Freiburg,Junior Adamu,,,23.0,2001.0,17.2,9,3,3,3,3,3,11,27.3,8,14,0,14,12,21,20,0
GER-Bundesliga,2425,Freiburg,Kiliann Sildillia,,,22.0,2002.0,8.9,17,10,8,6,3,7,13,53.8,6,16,5,11,11,28,38,0
GER-Bundesliga,2425,Freiburg,Lucas Höler,,,30.0,1994.0,20.7,37,24,18,15,4,9,24,37.5,15,29,7,22,7,44,36,0
GER-Bundesliga,2425,Freiburg,Lukas Kübler,,,31.0,1992.0,20.5,40,21,17,20,3,27,48,56.3,21,32,13,19,53,93,61,3
GER-Bundesliga,2425,Freiburg,Matthias Ginter,,,30.0,1994.0,28.5,30,17,15,11,4,15,28,53.6,13,35,23,12,19,49,146,5
GER-Bundesliga,2425,Freiburg,Max Rosenfelder,,,21.0,2003.0,13.9,27,17,17,10,0,14,19,73.7,5,17,9,8,7,34,65,0
GER-Bundesliga,2425,Freiburg,Maximilian Eggestein,,,27.0,1996.0,31.6,57,32,21,26,10,24,43,55.8,19,37,10,27,39,96,54,1
GER-Bundesliga,2425,Freiburg,Maximilian Philipp,,,30.0,1994.0,0.2,0,0,0,0,0,0,0,,0,0,0,0,0,0,0,0
GER-Bundesliga,2425,Freiburg,Merlin Röhl,,,22.0,2002.0,10.7,16,10,4,10,2,9,11,81.8,2,9,1,8,6,22,2,0
GER-Bundesliga,2425,Freiburg,Michael Gregoritsch,,,30.0,1994.0,7.1,4,2,1,0,3,1,5,20.0,4,2,1,1,1,5,10,0
GER-Bundesliga,2425,Freiburg,Nicolas Höfler,,,34.0,1990.0,8.8,33,23,13,18,2,20,31,64.5,11,7,1,6,14,47,28,1
GER-Bundesliga,2425,Freiburg,Noah Atubolu,,,22.0,2002.0,25.6,0,0,0,0,0,0,0,,0,0,0,0,0,0,13,4
GER-Bundesliga,2425,Freiburg,Noah Weißhaupt,,,22.0,2001.0,0.9,0,0,0,0,0,0,1,0.0,1,0,0,0,0,0,1,0
GER-Bundesliga,2425,Freiburg,Patrick Osterhage,,,24.0,2000.0,25.2,45,29,16,27,2,14,30,46.7,16,27,3,24,18,63,37,0
GER-Bundesliga,2425,Freiburg,Philipp Lienhart,,,28.0,1996.0,30.8,22,13,12,10,0,15,31,48.4,16,31,20,11,36,58,124,3
GER-Bundesliga,2425,Freiburg,Ritsu Doan,,,26.0,1998.0,31.8,66,42,33,26,7,25,46,54.3,21,57,2,55,14,80,47,1
GER-Bundesliga,2425,Freiburg,Roland Sallai,,,27.0,1997.0,0.5,2,1,1,1,0,0,0,,0,0,0,0,1,3,0,0
GER-Bundesliga,2425,Freiburg,Vincenzo Grifo,,,31.0,1993.0,27.0,30,22,12,13,5,15,34,44.1,19,24,2,22,9,39,23,2
GER-Bundesliga,2425,Gladbach,Alassane Pléa,,,31.0,1993.0,21.1,7,3,0,2,5,4,13,30.8,9,11,0,11,2,9,7,1
GER-Bundesliga,2425,Gladbach,Fabio Chiarodia,,,19.0,2005.0,4.2,10,4,6,4,0,4,6,66.7,2,8,3,5,9,19,53,1
GER-Bundesliga,2425,Gladbach,Florian Neuhaus,,,27.0,1997.0,4.2,10,3,7,3,0,7,17,41.2,10,9,2,7,6,16,5,1
GER-Bundesliga,2425,Gladbach,Franck Honorat,,,27.0,1996.0,16.0,17,7,10,4,3,2,8,25.0,6,9,1,8,5,22,28,1
GER-Bundesliga,2425,Gladbach,Grant Ranos,,,21.0,2003.0,0.2,1,0,0,1,0,0,1,0.0,1,2,0,2,0,1,0,0
GER-Bundesliga,2425,Gladbach,Joe Scally,,,21.0,2002.0,28.6,45,32,25,18,2,27,46,58.7,19,35,11,24,16,61,86,2
GER-Bundesliga,2425,Gladbach,Jonas Omlin,,,30.0,1994.0,10.9,0,0,0,0,0,0,1,0.0,1,0,0,0,0,0,5,1
GER-Bundesliga,2425,Gladbach,Julian Weigl,,,28.0,1995.0,32.0,53,25,24,24,5,28,46,60.9,18,54,27,27,48,101,86,3
GER-Bundesliga,2425,Gladbach,Kevin Stöger,,,30.0,1993.0,17.2,37,21,23,10,4,16,39,41.0,23,24,3,21,16,53,26,3
GER-Bundesliga,2425,Gladbach,Ko Itakura,,,27.0,1997.0,31.0,40,29,23,16,1,21,34,61.8,13,41,22,19,28,68,171,0
GER-Bundesliga,2425,Gladbach,Luca Netz,,,21.0,2003.0,10.8,24,14,14,8,2,13,19,68.4,6,17,4,13,10,34,36,0
GER-Bundesliga,2425,Gladbach,Lukas Ullrich,,,20.0,2004.0,21.1,25,16,18,6,1,15,42,35.7,27,26,9,17,23,48,74,1
GER-Bundesliga,2425,Gladbach,Marvin Friedrich,,,28.0,1995.0,11.0,15,9,12,3,0,9,16,56.3,7,16,12,4,5,20,57,0
GER-Bundesliga,2425,Gladbach,Moritz Nicolas,,,26.0,1997.0,18.2,0,0,0,0,0,0,0,,0,1,0,1,1,1,8,1
GER-Bundesliga,2425,Gladbach,Nathan N'Goumou,,,24.0,2000.0,9.2,17,11,11,4,2,6,11,54.5,5,8,2,6,4,21,16,0
GER-Bundesliga,2425,Gladbach,Nico Elvedi,,,27.0,1996.0,23.7,38,23,28,6,4,17,23,73.9,6,35,27,8,30,68,163,0
GER-Bundesliga,2425,Gladbach,Noah Pesch,,,19.0,2005.0,0.1,1,0,0,0,1,0,0,,0,0,0,0,0,1,0,0
GER-Bundesliga,2425,Gladbach,Philipp Sander,,,26.0,1998.0,15.6,33,17,16,15,2,10,23,43.5,13,16,7,9,23,56,44,3
GER-Bundesliga,2425,Gladbach,Robin Hack,,,25.0,1998.0,24.1,22,17,11,8,3,12,28,42.9,16,30,2,28,9,31,28,0
GER-Bundesliga,2425,Gladbach,Rocco Reitz,,,22.0,2002.0,20.3,52,24,24,24,4,24,43,55.8,19,39,16,23,53,105,59,2
GER-Bundesliga,2425,Gladbach,Shiō Fukuda,,,20.0,2004.0,0.7,0,0,0,0,0,0,0,,0,1,0,1,0,0,0,0
GER-Bundesliga,2425,Gladbach,Stefan Lainer,,,31.0,1992.0,8.4,22,13,16,5,1,12,14,85.7,2,12,6,6,12,34,30,0
GER-Bundesliga,2425,Gladbach,Tiago Cardoso,,,18.0,2006.0,4.2,1,0,1,0,0,1,1,100.0,0,0,0,0,0,1,2,2
GER-Bundesliga,2425,Gladbach,Tim Kleindienst,,,28.0,1995.0,30.4,30,15,6,15,9,10,35,28.6,25,45,9,36,12,42,66,1
GER-Bundesliga,2425,Gladbach,Tobias Sippel,,,36.0,1988.0,0.7,0,0,0,0,0,0,0,,0,0,0,0,0,0,0,0
GER-Bundesliga,2425,Gladbach,Tomáš Čvančara,,,23.0,2000.0,9.2,4,1,3,1,0,2,7,28.6,5,6,3,3,5,9,17,0
GER-Bundesliga,2425,Heidenheim,Adrian Beck,,,27.0,1997.0,17.8,36,17,18,12,6,12,35,34.3,23,31,2,29,9,45,17,0
GER-Bundesliga,2425,Heidenheim,Benedikt Gimber,,,27.0,1997.0,29.7,72,46,48,23,1,38,63,60.3,25,53,19,34,31,103,131,1
GER-Bundesliga,2425,Heidenheim,Budu Zivzivadze,,,30.0,1994.0,10.6,17,11,1,9,7,4,8,50.0,4,9,0,9,3,20,7,0
GER-Bundesliga,2425,Heidenheim,Denis Thomalla,,,31.0,1992.0,0.0,0,0,0,0,0,0,0,,0,0,0,0,0,0,0,0
GER-Bundesliga,2425,Heidenheim,Frank Feller,,,20.0,2004.0,1.3,0,0,0,0,0,0,0,,0,0,0,0,0,0,1,0
GER-Bundesliga,2425,Heidenheim,Frans Krätzig,,,21.0,2003.0,13.5,32,18,14,12,6,12,21,57.1,9,12,1,11,17,49,15,0
GER-Bundesliga,2425,Heidenheim,Jan Schöppner,,,25.0,1999.0,29.8,56,30,19,27,10,20,58,34.5,38,38,6,32,43,99,95,1
GER-Bundesliga,2425,Heidenheim,Jonas Föhrenbach,,,28.0,1996.0,20.4,45,24,25,15,5,22,35,62.9,13,29,3,26,16,61,57,0
GER-Bundesliga,2425,Heidenheim,Julian Niehues,,,23.0,2001.0,1.7,3,1,3,0,0,1,5,20.0,4,1,0,1,0,3,8,0
GER-Bundesliga,2425,Heidenheim,Kevin Müller,,,33.0,1991.0,32.7,3,2,3,0,0,3,3,100.0,0,0,0,0,0,3,13,4
GER-Bundesliga,2425,Heidenheim,Lennard Maloney,,,24.0,1999.0,8.4,20,11,12,7,1,14,23,60.9,9,9,2,7,14,34,38,0
GER-Bundesliga,2425,Heidenheim,Luca Kerber,,,22.0,2002.0,8.7,26,16,17,8,1,16,31,51.6,15,14,4,10,5,31,25,1
GER-Bundesliga,2425,Heidenheim,Léo Scienza,,,25.0,1998.0,12.8,17,12,10,5,2,7,18,38.9,11,13,1,12,5,22,9,1
GER-Bundesliga,2425,Heidenheim,Marnon Busch,,,29.0,1994.0,15.5,26,17,19,7,0,23,32,71.9,9,23,10,13,13,39,65,5
GER-Bundesliga,2425,Heidenheim,Marvin Pieringer,,,24.0,1999.0,24.5,23,13,5,12,6,5,10,50.0,5,21,2,19,8,31,32,0
GER-Bundesliga,2425,Heidenheim,Mathias Honsak,,,27.0,1996.0,13.1,15,8,10,5,0,10,23,43.5,13,19,4,15,10,25,31,0
GER-Bundesliga,2425,Heidenheim,Maximilian Breunig,,,23.0,2000.0,3.9,4,3,1,2,1,3,6,50.0,3,9,2,7,1,5,3,0
GER-Bundesliga,2425,Heidenheim,Mikkel Kaufmann,,,23.0,2001.0,4.1,6,4,1,3,2,2,5,40.0,3,5,2,3,2,8,7,0
GER-Bundesliga,2425,Heidenheim,Niklas Dorsch,,,26.0,1998.0,14.8,27,16,12,15,0,13,22,59.1,9,14,1,13,17,44,17,2
GER-Bundesliga,2425,Heidenheim,Norman Theuerkauf,,,37.0,1987.0,0.2,0,0,0,0,0,0,0,,0,0,0,0,0,0,0,0
GER-Bundesliga,2425,Heidenheim,Omar Traoré,,,26.0,1998.0,29.1,50,26,31,16,3,25,41,61.0,16,35,6,29,21,71,66,0
GER-Bundesliga,2425,Heidenheim,Patrick Mainka,,,29.0,1994.0,34.0,58,30,36,20,2,35,55,63.6,20,61,36,25,68,126,206,0
GER-Bundesliga,2425,Heidenheim,Paul Wanner,,,18.0,2005.0,19.7,40,27,16,21,3,15,32,46.9,17,15,0,15,4,44,20,0
GER-Bundesliga,2425,Heidenheim,Sirlord Conteh,,,28.0,1996.0,9.9,9,5,3,6,0,2,7,28.6,5,1,1,0,1,10,8,0
GER-Bundesliga,2425,Heidenheim,Stefan Schimmer,,,30.0,1994.0,2.7,2,0,1,1,0,1,2,50.0,1,1,0,1,0,2,4,0
GER-Bundesliga,2425,Heidenheim,Thomas Keller,,,24.0,1999.0,1.6,6,5,5,1,0,4,6,66.7,2,3,1,2,4,10,11,0
GER-Bundesliga,2425,Heidenheim,Tim Siersleben,,,24.0,2000.0,13.1,21,14,12,8,1,7,17,41.2,10,19,6,13,20,41,66,0
GER-Bundesliga,2425,Hoffenheim,Adam Hložek,,,22.0,2002.0,20.8,22,10,7,8,7,11,20,55.0,9,13,1,12,4,26,20,0
GER-Bundesliga,2425,Hoffenheim,Alexander Prass,,,23.0,2001.0,17.4,42,23,24,15,3,24,59,40.7,35,33,6,27,9,51,53,4
GER-Bundesliga,2425,Hoffenheim,Andrej Kramarić,,,33.0,1991.0,30.7,15,8,5,8,2,6,11,54.5,5,16,3,13,7,22,11,1
GER-Bundesliga,2425,Hoffenheim,Anton Stach,,,25.0,1998.0,28.7,66,46,25,37,4,32,47,68.1,15,47,13,34,46,112,101,2
GER-Bundesliga,2425,Hoffenheim,Arthur Chaves,,,23.0,2001.0,24.3,51,36,28,19,4,25,50,50.0,25,47,20,27,37,88,136,3
GER-Bundesliga,2425,Hoffenheim,Bazoumana Touré,,,18.0,2006.0,6.8,12,10,2,7,3,2,8,25.0,6,4,0,4,3,15,2,0
GER-Bundesliga,2425,Hoffenheim,David Jurásek,,,23.0,2000.0,6.9,6,3,3,2,1,2,5,40.0,3,5,0,5,6,12,17,0
GER-Bundesliga,2425,Hoffenheim,David Mokwa,,,20.0,2004.0,0.2,1,0,1,0,0,0,0,,0,0,0,0,0,1,0,0
GER-Bundesliga,2425,Hoffenheim,Dennis Geiger,,,26.0,1998.0,8.2,24,11,9,13,2,12,19,63.2,7,15,2,13,7,31,6,1
GER-Bundesliga,2425,Hoffenheim,Diadie Samassékou,,,28.0,1996.0,3.2,5,5,1,2,2,2,4,50.0,2,4,2,2,5,10,5,0
GER-Bundesliga,2425,Hoffenheim,Erencan Yardimci,,,22.0,2002.0,3.5,4,3,1,3,0,1,2,50.0,1,2,0,2,1,5,2,0
GER-Bundesliga,2425,Hoffenheim,Finn Ole Becker,,,24.0,2000.0,7.4,11,5,4,6,1,1,4,25.0,3,7,3,4,10,21,20,0
GER-Bundesliga,2425,Hoffenheim,Florian Grillitsch,,,28.0,1995.0,6.7,15,9,5,9,1,8,14,57.1,6,6,2,4,8,23,18,0
GER-Bundesliga,2425,Hoffenheim,Florian Micheler,,,19.0,2005.0,0.4,0,0,0,0,0,0,2,0.0,2,0,0,0,0,0,0,0
GER-Bundesliga,2425,Hoffenheim,Gift Orban,,,22.0,2002.0,7.6,3,1,2,1,0,1,6,16.7,5,7,0,7,0,3,3,0
GER-Bundesliga,2425,Hoffenheim,Grischa Prömel,,,29.0,1995.0,1.9,0,0,0,0,0,0,1,0.0,1,1,1,0,2,2,4,0
GER-Bundesliga,2425,Hoffenheim,Hannes Behrens,,,,,0.3,1,1,0,1,0,0,0,,0,1,0,1,2,3,0,0
GER-Bundesliga,2425,Hoffenheim,Haris Tabakovic,,,30.0,1994.0,9.1,3,1,1,0,2,0,3,0.0,3,4,2,2,1,4,16,0
GER-Bundesliga,2425,Hoffenheim,Ihlas Bebou,,,30.0,1994.0,0.1,0,0,0,0,0,0,0,,0,0,0,0,0,0,0,0
GER-Bundesliga,2425,Hoffenheim,Jacob Bruun Larsen,,,25.0,1998.0,4.4,4,3,1,2,1,3,8,37.5,5,5,1,4,1,5,2,0
GER-Bundesliga,2425,Hoffenheim,Kevin Akpoguma,,,29.0,1995.0,24.7,54,27,36,12,6,30,46,65.2,16,65,37,28,29,83,115,1
GER-Bundesliga,2425,Hoffenheim,Leo Skiri Østigård,,,24.0,1999.0,10.3,9,7,5,4,0,4,6,66.7,2,17,9,8,9,18,111,0
GER-Bundesliga,2425,Hoffenheim,Luca Philipp,,,23.0,2000.0,6.0,1,0,1,0,0,1,1,100.0,0,0,0,0,0,1,1,0
GER-Bundesliga,2425,Hoffenheim,Marius Bülter,,,31.0,1993.0,19.2,13,10,5,6,2,9,17,52.9,8,10,3,7,4,17,14,1
GER-Bundesliga,2425,Hoffenheim,Max Moerstedt,,,,,5.0,5,5,1,3,1,1,2,50.0,1,4,0,4,0,5,5,0
GER-Bundesliga,2425,Hoffenheim,Mergim Berisha,,,26.0,1998.0,3.7,3,3,1,2,0,0,3,0.0,3,2,1,1,0,3,3,0
GER-Bundesliga,2425,Hoffenheim,Oliver Baumann,,,34.0,1990.0,28.0,2,2,2,0,0,2,4,50.0,2,0,0,0,0,2,15,2
GER-Bundesliga,2425,Hoffenheim,Paul Hennrich,,,19.0,2005.0,0.1,0,0,0,0,0,0,0,,0,1,1,0,0,0,0,0
GER-Bundesliga,2425,Hoffenheim,Pavel Kadeřábek,,,32.0,1992.0,17.5,25,14,14,4,7,15,31,48.4,16,13,3,10,20,45,54,1
GER-Bundesliga,2425,Hoffenheim,Robin Hranáč,,,24.0,2000.0,2.4,0,0,0,0,0,0,1,0.0,1,3,2,1,5,5,9,1
GER-Bundesliga,2425,Hoffenheim,Stanley N'Soki,,,25.0,1999.0,14.5,22,16,13,7,2,12,23,52.2,11,22,7,15,26,48,58,3
GER-Bundesliga,2425,Hoffenheim,Tim Drexler,,,19.0,2005.0,4.0,17,7,11,6,0,9,12,75.0,3,6,4,2,1,18,9,1
GER-Bundesliga,2425,Hoffenheim,Tom Bischof,,,19.0,2005.0,28.4,95,53,36,45,14,40,77,51.9,37,66,11,55,30,125,53,1
GER-Bundesliga,2425,Hoffenheim,Umut Tohumcu,,,19.0,2004.0,4.2,9,5,3,5,1,5,7,71.4,2,5,0,5,3,12,6,0
GER-Bundesliga,2425,Hoffenheim,Valentin Gendrey,,,24.0,2000.0,15.7,30,12,19,9,2,11,18,61.1,7,19,5,14,15,45,53,0
GER-Bundesliga,2425,Holstein Kiel,Alexander Bernhardsson,,,25.0,1998.0,14.0,29,15,9,9,11,20,31,64.5,11,14,0,14,5,34,25,0
GER-Bundesliga,2425,Holstein Kiel,Andu Kelati,,,21.0,2002.0,3.2,7,4,2,4,1,2,5,40.0,3,4,1,3,3,10,3,0
GER-Bundesliga,2425,Holstein Kiel,Armin Gigovic,,,22.0,2002.0,21.1,25,13,14,8,3,5,21,23.8,16,20,1,19,21,46,33,0
GER-Bundesliga,2425,Holstein Kiel,Benedikt Pichler,,,27.0,1997.0,8.7,5,2,1,0,4,2,4,50.0,2,4,2,2,2,7,11,0
GER-Bundesliga,2425,Holstein Kiel,Carl Johansson,,,30.0,1994.0,6.3,4,2,4,0,0,3,7,42.9,4,12,8,4,10,14,54,1
GER-Bundesliga,2425,Holstein Kiel,David Zec,,,24.0,2000.0,17.1,23,10,17,6,0,13,20,65.0,7,32,18,14,17,40,93,3
GER-Bundesliga,2425,Holstein Kiel,Dominik Javorček,,,21.0,2002.0,4.3,3,0,3,0,0,1,5,20.0,4,7,3,4,5,8,26,1
GER-Bundesliga,2425,Holstein Kiel,Finn Porath,,,27.0,1997.0,21.9,45,26,24,14,7,26,53,49.1,27,27,9,18,21,66,67,0
GER-Bundesliga,2425,Holstein Kiel,Ivan Nekić,,,23.0,2000.0,0.8,1,1,1,0,0,1,2,50.0,1,1,0,1,3,4,2,0
GER-Bundesliga,2425,Holstein Kiel,Jann-Fiete Arp,,,24.0,2000.0,7.9,13,10,5,2,6,4,13,30.8,9,6,0,6,3,16,8,1
GER-Bundesliga,2425,Holstein Kiel,John Tolkin,,,22.0,2002.0,8.2,18,11,11,7,0,12,14,85.7,2,10,2,8,8,26,54,0
GER-Bundesliga,2425,Holstein Kiel,Lasse Rosenboom,,,22.0,2002.0,19.3,47,35,25,16,6,32,47,68.1,15,28,9,19,19,66,71,3
GER-Bundesliga,2425,Holstein Kiel,Lewis Holtby,,,33.0,1990.0,13.8,34,20,19,10,5,12,28,42.9,16,14,2,12,21,55,26,3
GER-Bundesliga,2425,Holstein Kiel,Magnus Knudsen,,,23.0,2001.0,20.6,48,29,21,21,6,25,44,56.8,19,18,4,14,12,60,44,0
GER-Bundesliga,2425,Holstein Kiel,Marco Komenda,,,27.0,1996.0,14.5,26,17,12,13,1,11,15,73.3,4,23,11,12,6,32,68,0
GER-Bundesliga,2425,Holstein Kiel,Marko Ivezić,,,22.0,2001.0,18.4,29,19,20,6,3,15,42,35.7,27,25,13,12,27,56,103,2
GER-Bundesliga,2425,Holstein Kiel,Marvin Schulz,,,29.0,1995.0,3.4,6,5,2,2,2,2,8,25.0,6,12,8,4,0,6,17,0
GER-Bundesliga,2425,Holstein Kiel,Max Geschwill,,,23.0,2001.0,14.2,26,21,13,12,1,14,19,73.7,5,14,9,5,30,56,53,1
GER-Bundesliga,2425,Holstein Kiel,Nicolai Remberg,,,24.0,2000.0,26.9,45,25,24,17,4,19,41,46.3,22,46,20,26,29,74,100,0
GER-Bundesliga,2425,Holstein Kiel,Patrick Erras,,,29.0,1995.0,9.2,8,5,6,2,0,2,9,22.2,7,13,11,2,9,17,64,0
GER-Bundesliga,2425,Holstein Kiel,Phil Harres,,,22.0,2002.0,17.2,10,10,3,4,3,4,8,50.0,4,17,3,14,5,15,20,0
GER-Bundesliga,2425,Holstein Kiel,Shuto Machino,,,24.0,1999.0,21.7,8,5,4,3,1,6,16,37.5,10,12,3,9,7,15,28,1
GER-Bundesliga,2425,Holstein Kiel,Steven Skrzybski,,,31.0,1992.0,14.7,19,6,7,6,6,7,24,29.2,17,16,0,16,11,30,11,0
GER-Bundesliga,2425,Holstein Kiel,Thomas Dähne,,,30.0,1994.0,9.0,0,0,0,0,0,0,0,,0,0,0,0,0,0,7,2
GER-Bundesliga,2425,Holstein Kiel,Timo Becker,,,27.0,1997.0,27.2,53,33,39,9,5,34,46,73.9,12,30,17,13,17,70,110,1
GER-Bundesliga,2425,Holstein Kiel,Timon Weiner,,,25.0,1999.0,25.0,0,0,0,0,0,0,1,0.0,1,0,0,0,0,0,17,3
GER-Bundesliga,2425,Holstein Kiel,Tymoteusz Puchacz,,,25.0,1999.0,4.4,9,4,6,3,0,5,7,71.4,2,4,1,3,3,12,11,0
GER-Bundesliga,2425,Leverkusen,Aleix García,,,27.0,1997.0,16.2,13,7,4,6,3,7,15,46.7,8,12,2,10,11,24,24,1
GER-Bundesliga,2425,Leverkusen,Amine Adli,,,24.0,2000.0,8.5,15,9,4,2,9,4,11,36.4,7,11,0,11,0,15,4,0
GER-Bundesliga,2425,Leverkusen,Arthur,,,21.0,2003.0,8.4,14,11,3,9,2,5,10,50.0,5,8,0,8,9,23,29,0
GER-Bundesliga,2425,Leverkusen,Edmond Tapsoba,,,25.0,1999.0,27.9,39,24,19,16,4,22,39,56.4,17,21,14,7,24,63,89,3
GER-Bundesliga,2425,Leverkusen,Emi Buendía,,,27.0,1996.0,2.9,6,5,1,4,1,5,8,62.5,3,6,0,6,0,6,0,0
GER-Bundesliga,2425,Leverkusen,Exequiel Palacios,,,25.0,1998.0,12.8,22,15,8,10,4,10,18,55.6,8,14,1,13,13,35,15,1
GER-Bundesliga,2425,Leverkusen,Florian Wirtz,,,21.0,2003.0,26.1,32,20,10,12,10,9,22,40.9,13,32,3,29,10,42,6,1
GER-Bundesliga,2425,Leverkusen,Granit Xhaka,,,31.0,1992.0,32.1,48,26,15,27,6,24,42,57.1,18,30,7,23,12,60,52,6
GER-Bundesliga,2425,Leverkusen,Jeanuël Belocian,,,19.0,2005.0,0.8,1,1,1,0,0,1,1,100.0,0,0,0,0,0,1,2,0
GER-Bundesliga,2425,Leverkusen,Jeremie Frimpong,,,23.0,2000.0,25.7,33,25,14,12,7,16,29,55.2,13,25,0,25,8,41,22,1
GER-Bundesliga,2425,Leverkusen,Jonas Hofmann,,,32.0,1992.0,4.0,2,0,0,2,0,1,4,25.0,3,2,0,2,0,2,3,0
GER-Bundesliga,2425,Leverkusen,Jonathan Tah,,,28.0,1996.0,33.0,19,12,12,6,1,10,16,62.5,6,22,16,6,36,55,157,2
GER-Bundesliga,2425,Leverkusen,Lukáš Hrádecký,,,34.0,1989.0,29.0,0,0,0,0,0,0,1,0.0,1,0,0,0,0,0,8,2
GER-Bundesliga,2425,Leverkusen,Mario Hermoso,,,29.0,1995.0,3.3,0,0,0,0,0,0,0,,0,3,1,2,9,9,15,1
GER-Bundesliga,2425,Leverkusen,Martin Terrier,,,27.0,1997.0,6.5,4,2,1,0,3,1,4,25.0,3,3,0,3,1,5,1,0
GER-Bundesliga,2425,Leverkusen,Matej Kovar,,,24.0,2000.0,5.0,0,0,0,0,0,0,0,,0,0,0,0,0,0,0,1
GER-Bundesliga,2425,Leverkusen,Nathan Tella,,,25.0,1999.0,15.1,16,11,4,7,5,5,13,38.5,8,15,1,14,4,20,10,0
GER-Bundesliga,2425,Leverkusen,Nordi Mukiele,,,26.0,1997.0,10.0,20,16,8,8,4,12,18,66.7,6,10,0,10,16,36,37,2
GER-Bundesliga,2425,Leverkusen,Patrik Schick,,,28.0,1996.0,18.7,6,5,1,3,2,1,5,20.0,4,9,1,8,4,10,17,1
GER-Bundesliga,2425,Leverkusen,Piero Hincapié,,,22.0,2002.0,29.7,52,40,27,15,10,25,41,61.0,16,40,20,20,32,84,114,1
GER-Bundesliga,2425,Leverkusen,Robert Andrich,,,29.0,1994.0,17.8,24,12,8,14,2,7,14,50.0,7,16,8,8,29,53,23,0
GER-Bundesliga,2425,Leverkusen,Victor Boniface,,,23.0,2000.0,11.2,5,4,0,3,2,3,4,75.0,1,1,0,1,0,5,5,0
GER-Bundesliga,2425,Leverkusen,Álex Grimaldo,,,28.0,1995.0,29.3,24,14,13,7,4,16,42,38.1,26,22,3,19,16,40,43,3
GER-Bundesliga,2425,Mainz 05,Andreas Hanche-Olsen,,,27.0,1997.0,14.3,21,13,12,8,1,9,12,75.0,3,25,18,7,12,33,85,2
GER-Bundesliga,2425,Mainz 05,Anthony Caci,,,27.0,1997.0,29.8,60,40,23,25,12,28,44,63.6,16,33,8,25,27,87,47,2
GER-Bundesliga,2425,Mainz 05,Armindo Sieb,,,21.0,2003.0,8.5,10,4,4,5,1,3,10,30.0,7,4,0,4,1,11,7,0
GER-Bundesliga,2425,Mainz 05,Arnaud Nordin,,,26.0,1998.0,0.9,2,0,0,2,0,1,1,100.0,0,2,1,1,0,2,2,0
GER-Bundesliga,2425,Mainz 05,Aymen Barkok,,,26.0,1998.0,0.8,2,1,1,1,0,1,1,100.0,0,1,1,0,2,4,0,0
GER-Bundesliga,2425,Mainz 05,Danny da Costa,,,31.0,1993.0,22.3,42,23,23,15,4,17,27,63.0,10,19,10,9,27,69,95,3
GER-Bundesliga,2425,Mainz 05,Dominik Kohr,,,30.0,1994.0,25.5,62,46,34,21,7,35,55,63.6,20,43,24,19,42,104,127,0
GER-Bundesliga,2425,Mainz 05,Gabriel Vidovic,,,20.0,2003.0,0.0,0,0,0,0,0,0,0,,0,0,0,0,0,0,0,0
GER-Bundesliga,2425,Mainz 05,Hong Hyunseok,,,25.0,1999.0,5.9,8,3,3,3,2,1,4,25.0,3,7,1,6,7,15,9,0
GER-Bundesliga,2425,Mainz 05,Jonathan Burkardt,,,24.0,2000.0,23.4,15,8,1,7,7,6,10,60.0,4,11,1,10,1,16,14,0
GER-Bundesliga,2425,Mainz 05,Kaishu Sano,,,23.0,2000.0,33.8,61,36,22,31,8,25,52,48.1,27,66,14,52,65,126,56,1
GER-Bundesliga,2425,Mainz 05,Karim Onisiwo,,,32.0,1992.0,1.2,1,1,0,0,1,0,0,,0,0,0,0,0,1,0,0
GER-Bundesliga,2425,Mainz 05,Lasse Rieß,,,23.0,2001.0,2.0,0,0,0,0,0,0,0,,0,0,0,0,0,0,5,0
GER-Bundesliga,2425,Mainz 05,Lee Jae-sung,,,31.0,1992.0,29.4,42,21,16,19,7,15,39,38.5,24,39,3,36,35,77,38,0
GER-Bundesliga,2425,Mainz 05,Lennard Maloney,,,24.0,1999.0,0.3,2,1,0,1,1,1,1,100.0,0,2,0,2,0,2,3,0
GER-Bundesliga,2425,Mainz 05,Maxim Leitsch,,,26.0,1998.0,7.5,12,4,6,4,2,7,9,77.8,2,12,4,8,10,22,42,1
GER-Bundesliga,2425,Mainz 05,Moritz Jenz,,,25.0,1999.0,17.8,36,20,18,18,0,16,21,76.2,5,23,14,9,30,66,128,2
GER-Bundesliga,2425,Mainz 05,Nadiem Amiri,,,27.0,1996.0,27.5,50,23,13,28,9,19,46,41.3,27,19,4,15,16,66,30,2
GER-Bundesliga,2425,Mainz 05,Nelson Weiper,,,19.0,2005.0,7.8,5,4,2,3,0,2,4,50.0,2,5,0,5,2,7,5,1
GER-Bundesliga,2425,Mainz 05,Nikolas Veratschnig,,,21.0,2003.0,4.0,9,6,1,4,4,2,3,66.7,1,4,0,4,5,14,8,0
GER-Bundesliga,2425,Mainz 05,Paul Nebel,,,21.0,2002.0,26.1,38,24,11,18,9,11,35,31.4,24,54,4,50,13,51,30,2
GER-Bundesliga,2425,Mainz 05,Phillipp Mwene,,,30.0,1994.0,29.0,51,29,23,22,6,19,46,41.3,27,27,6,21,24,75,51,1
GER-Bundesliga,2425,Mainz 05,Robin Zentner,,,29.0,1994.0,32.0,2,1,2,0,0,1,2,50.0,1,0,0,0,0,2,31,4
GER-Bundesliga,2425,Mainz 05,Silvan Widmer,,,31.0,1993.0,5.6,11,5,3,6,2,8,12,66.7,4,7,1,6,5,16,27,0
GER-Bundesliga,2425,Mainz 05,Stefan Bell,,,32.0,1991.0,16.0,22,12,16,6,0,9,14,64.3,5,16,14,2,28,50,107,1
GER-Bundesliga,2425,RB Leipzig,Amadou Haidara,,,26.0,1998.0,14.7,30,17,12,16,2,12,29,41.4,17,42,12,30,18,48,56,1
GER-Bundesliga,2425,RB Leipzig,André Silva,,,28.0,1995.0,1.5,1,1,1,0,0,0,1,0.0,1,1,0,1,1,2,2,0
GER-Bundesliga,2425,RB Leipzig,Antonio Nusa,,,19.0,2005.0,17.3,30,17,16,9,5,18,36,50.0,18,22,2,20,8,38,11,0
GER-Bundesliga,2425,RB Leipzig,Arthur Vermeeren,,,19.0,2005.0,17.5,32,19,14,13,5,14,47,29.8,33,34,12,22,23,55,25,2
GER-Bundesliga,2425,RB Leipzig,Assan Ouedraogo,,,18.0,2006.0,0.6,0,0,0,0,0,0,0,,0,1,0,1,0,0,0,0
GER-Bundesliga,2425,RB Leipzig,Benjamin Henrichs,,,27.0,1997.0,10.4,32,16,18,10,4,14,27,51.9,13,22,3,19,15,47,33,0
GER-Bundesliga,2425,RB Leipzig,Benjamin Šeško,,,21.0,2003.0,26.4,7,3,0,4,3,3,11,27.3,8,15,4,11,5,12,20,0
GER-Bundesliga,2425,RB Leipzig,Castello Lukeba,,,21.0,2002.0,17.5,31,17,15,12,4,17,24,70.8,7,29,12,17,17,48,74,0
GER-Bundesliga,2425,RB Leipzig,Christoph Baumgartner,,,24.0,1999.0,17.9,44,28,13,19,12,17,42,40.5,25,45,9,36,12,56,24,2
GER-Bundesliga,2425,RB Leipzig,David Raum,,,26.0,1998.0,19.8,38,28,16,14,8,20,35,57.1,15,25,8,17,9,47,47,4
GER-Bundesliga,2425,RB Leipzig,El Chadaille Bitshiabu,,,19.0,2005.0,12.6,27,18,17,9,1,10,19,52.6,9,25,14,11,13,40,97,2
GER-Bundesliga,2425,RB Leipzig,Elif Elmas,,,24.0,1999.0,0.5,3,1,3,0,0,1,3,33.3,2,2,0,2,0,3,2,0
GER-Bundesliga,2425,RB Leipzig,Faik Sakar,,,16.0,2008.0,0.0,0,0,0,0,0,0,0,,0,0,0,0,0,0,0,0
GER-Bundesliga,2425,RB Leipzig,Kevin Kampl,,,33.0,1990.0,17.7,27,18,11,10,6,16,26,61.5,10,25,6,19,24,51,25,0
GER-Bundesliga,2425,RB Leipzig,Kosta Nedeljković,,,18.0,2005.0,5.3,11,8,5,6,0,6,10,60.0,4,6,4,2,2,13,14,0
GER-Bundesliga,2425,RB Leipzig,Loïs Openda,,,24.0,2000.0,27.3,9,4,3,4,2,3,11,27.3,8,19,1,18,5,14,12,0
GER-Bundesliga,2425,RB Leipzig,Lukas Klostermann,,,28.0,1996.0,20.4,27,14,18,7,2,14,24,58.3,10,31,17,14,24,51,143,3
GER-Bundesliga,2425,RB Leipzig,Lutsharel Geertruida,,,24.0,2000.0,17.3,35,24,24,11,0,15,31,48.4,16,15,4,11,16,51,59,4
GER-Bundesliga,2425,RB Leipzig,Maarten Vandevoordt,,,22.0,2002.0,4.8,1,0,1,0,0,1,1,100.0,0,0,0,0,0,1,4,0
GER-Bundesliga,2425,RB Leipzig,Mohamed Simakan,,,24.0,2000.0,0.6,0,0,0,0,0,0,0,,0,0,0,0,2,2,0,0
GER-Bundesliga,2425,RB Leipzig,Nicolas Seiwald,,,23.0,2001.0,23.2,53,31,19,29,5,25,50,50.0,25,43,10,33,31,84,76,2
GER-Bundesliga,2425,RB Leipzig,Péter Gulácsi,,,34.0,1990.0,29.2,1,1,1,0,0,1,2,50.0,1,0,0,0,0,1,16,4
GER-Bundesliga,2425,RB Leipzig,Ridle Baku,,,26.0,1998.0,14.2,24,19,9,13,2,9,23,39.1,14,18,2,16,9,33,45,0
GER-Bundesliga,2425,RB Leipzig,Tidiam Gomis,,,17.0,2006.0,1.7,0,0,0,0,0,0,0,,0,2,0,2,1,1,0,0
GER-Bundesliga,2425,RB Leipzig,Viggo Gebel,,,16.0,2007.0,0.2,0,0,0,0,0,0,0,,0,0,0,0,0,0,0,0
GER-Bundesliga,2425,RB Leipzig,Willi Orban,,,31.0,1992.0,24.7,38,21,23,14,1,23,32,71.9,9,45,31,14,21,59,169,4
GER-Bundesliga,2425,RB Leipzig,Xaver Schlager,,,26.0,1997.0,2.0,4,2,2,1,1,3,7,42.9,4,7,0,7,0,4,3,0
GER-Bundesliga,2425,RB Leipzig,Xavi Simons,,,21.0,2003.0,23.9,28,21,5,15,8,12,26,46.2,14,19,3,16,12,40,19,1
GER-Bundesliga,2425,RB Leipzig,Yussuf Poulsen,,,30.0,1994.0,4.2,10,5,2,6,2,4,8,50.0,4,7,2,5,0,10,14,0
GER-Bundesliga,2425,St. Pauli,Abdoulie Ceesay,,,20.0,2004.0,0.7,3,3,1,1,1,2,3,66.7,1,2,0,2,0,3,1,0
GER-Bundesliga,2425,St. Pauli,Adam Dźwigała,,,28.0,1995.0,4.1,20,10,13,6,1,11,16,68.8,5,6,1,5,4,24,28,0
GER-Bundesliga,2425,St. Pauli,Andreas Albers,,,34.0,1990.0,0.7,1,1,0,0,1,0,1,0.0,1,0,0,0,0,1,1,0
GER-Bundesliga,2425,St. Pauli,Ben Alexander Voll,,,23.0,2000.0,1.0,0,0,0,0,0,0,0,,0,0,0,0,0,0,0,0
GER-Bundesliga,2425,St. Pauli,Carlo Boukhalfa,,,25.0,1999.0,18.3,26,11,7,17,2,7,19,36.8,12,22,3,19,12,38,25,1
GER-Bundesliga,2425,St. Pauli,Connor Metcalfe,,,24.0,1999.0,4.0,2,0,1,1,0,0,5,0.0,5,4,0,4,3,5,8,0
GER-Bundesliga,2425,St. Pauli,Danel Sinani,,,27.0,1997.0,13.9,14,11,2,7,5,6,14,42.9,8,12,1,11,1,15,13,0
GER-Bundesliga,2425,St. Pauli,David Nemeth,,,23.0,2001.0,23.7,43,29,25,16,2,25,43,58.1,18,29,11,18,18,61,94,2
GER-Bundesliga,2425,St. Pauli,Elias Saad,,,24.0,1999.0,10.0,20,13,7,8,5,10,20,50.0,10,14,0,14,3,23,1,0
GER-Bundesliga,2425,St. Pauli,Eric Smith,,,27.0,1997.0,31.4,46,29,26,17,3,23,40,57.5,17,37,10,27,37,83,104,4
GER-Bundesliga,2425,St. Pauli,Erik Ahlstrand,,,22.0,2001.0,0.5,0,0,0,0,0,0,0,,0,1,0,1,1,1,1,0
GER-Bundesliga,2425,St. Pauli,Finley Stevens,,,21.0,2003.0,0.0,0,0,0,0,0,0,0,,0,0,0,0,0,0,0,0
GER-Bundesliga,2425,St. Pauli,Hauke Wahl,,,30.0,1994.0,33.0,36,27,21,13,2,23,38,60.5,15,44,25,19,31,67,170,4
GER-Bundesliga,2425,St. Pauli,Jackson Irvine,,,31.0,1993.0,29.0,56,28,24,26,6,25,45,55.6,20,27,5,22,36,92,63,2
GER-Bundesliga,2425,St. Pauli,James Sands,,,24.0,2000.0,5.0,15,6,5,8,2,4,4,100.0,0,5,1,4,5,20,8,0
GER-Bundesliga,2425,St. Pauli,Johannes Eggestein,,,26.0,1998.0,20.6,5,3,0,2,3,1,5,20.0,4,5,0,5,0,5,8,0
GER-Bundesliga,2425,St. Pauli,Karol Mets,,,31.0,1993.0,10.0,13,8,6,7,0,4,7,57.1,3,9,3,6,12,25,60,0
GER-Bundesliga,2425,St. Pauli,Lars Ritzka,,,26.0,1998.0,10.2,49,29,28,16,5,25,41,61.0,16,16,2,14,11,60,41,0
GER-Bundesliga,2425,St. Pauli,Manolis Saliakas,,,27.0,1996.0,25.7,46,22,24,18,4,25,49,51.0,24,38,8,30,20,66,62,0
GER-Bundesliga,2425,St. Pauli,Maurides,,,30.0,1994.0,0.0,0,0,0,0,0,0,0,,0,0,0,0,0,0,0,0
GER-Bundesliga,2425,St. Pauli,Morgan Guilavogui,,,26.0,1998.0,20.1,32,17,11,16,5,14,31,45.2,17,28,0,28,13,45,33,0
GER-Bundesliga,2425,St. Pauli,Nikola Vasilj,,,28.0,1995.0,33.0,0,0,0,0,0,0,2,0.0,2,0,0,0,0,0,22,3
GER-Bundesliga,2425,St. Pauli,Noah Weißhaupt,,,22.0,2001.0,12.9,6,4,3,0,3,3,8,37.5,5,7,0,7,2,8,8,1
GER-Bundesliga,2425,St. Pauli,Oladapo Afolayan,,,26.0,1998.0,18.2,17,8,4,8,5,7,19,36.8,12,17,1,16,8,25,20,0
GER-Bundesliga,2425,St. Pauli,Philipp Treu,,,23.0,2000.0,32.0,61,42,35,17,9,39,68,57.4,29,52,12,40,19,80,87,2
GER-Bundesliga,2425,St. Pauli,Robert Wagner,,,21.0,2003.0,4.5,8,3,2,6,0,4,13,30.8,9,8,0,8,2,10,12,0
GER-Bundesliga,2425,St. Pauli,Scott Banks,,,22.0,2001.0,1.3,1,1,1,0,0,0,2,0.0,2,0,0,0,2,3,2,0
GER-Bundesliga,2425,St. Pauli,Siebe Van Der Heyden,,,26.0,1998.0,9.7,17,10,10,7,0,8,18,44.4,10,8,4,4,17,34,43,2
GER-Bundesliga,2425,Stuttgart,Alexander Nübel,,,27.0,1996.0,34.0,0,0,0,0,0,0,1,0.0,1,0,0,0,0,0,18,3
GER-Bundesliga,2425,Stuttgart,Ameen Al-Dakhil,,,22.0,2002.0,4.8,6,6,4,2,0,4,4,100.0,0,12,8,4,9,15,30,1
GER-Bundesliga,2425,Stuttgart,Angelo Stiller,,,23.0,2001.0,30.5,49,27,18,25,6,14,30,46.7,16,29,9,20,26,75,50,4
GER-Bundesliga,2425,Stuttgart,Anrie Chase,,,20.0,2004.0,8.2,10,4,6,4,0,5,7,71.4,2,10,6,4,9,19,35,0
GER-Bundesliga,2425,Stuttgart,Anthony Rouault,,,23.0,2001.0,13.5,15,11,10,3,2,10,15,66.7,5,18,9,9,19,34,63,1
GER-Bundesliga,2425,Stuttgart,Atakan Karazor,,,27.0,1996.0,29.1,59,29,19,28,12,29,57,50.9,28,39,7,32,32,91,51,1
GER-Bundesliga,2425,Stuttgart,Chris Führich,,,26.0,1998.0,22.0,15,10,5,5,5,13,27,48.1,14,23,2,21,6,21,19,0
GER-Bundesliga,2425,Stuttgart,Dan-Axel Zagadou,,,25.0,1999.0,0.3,0,0,0,0,0,0,0,,0,0,0,0,1,1,1,0
GER-Bundesliga,2425,Stuttgart,Deniz Undav,,,28.0,1996.0,19.2,11,10,2,3,6,1,17,5.9,16,15,2,13,3,14,10,0
GER-Bundesliga,2425,Stuttgart,El Bilal Touré,,,22.0,2001.0,4.0,4,1,1,1,2,3,3,100.0,0,1,0,1,0,4,1,0
GER-Bundesliga,2425,Stuttgart,Enzo Millot,,,22.0,2002.0,20.5,30,13,10,15,5,12,35,34.3,23,27,0,27,13,43,6,1
GER-Bundesliga,2425,Stuttgart,Ermedin Demirović,,,26.0,1998.0,20.6,12,7,3,4,5,3,12,25.0,9,14,3,11,3,15,12,0
GER-Bundesliga,2425,Stuttgart,Fabian Rieder,,,22.0,2002.0,9.6,17,14,4,9,4,7,23,30.4,16,10,1,9,10,27,7,1
GER-Bundesliga,2425,Stuttgart,Finn Jeltsch,,,18.0,2006.0,8.7,18,13,6,11,1,12,15,80.0,3,12,6,6,13,31,27,2
GER-Bundesliga,2425,Stuttgart,Frans Krätzig,,,21.0,2003.0,0.6,2,1,1,0,1,1,3,33.3,2,2,1,1,0,2,1,0
GER-Bundesliga,2425,Stuttgart,Jacob Bruun Larsen,,,25.0,1998.0,4.6,1,1,1,0,0,0,2,0.0,2,7,0,7,1,2,4,1
GER-Bundesliga,2425,Stuttgart,Jamie Leweling,,,23.0,2001.0,18.5,16,6,6,3,7,11,25,44.0,14,22,1,21,11,27,17,1
GER-Bundesliga,2425,Stuttgart,Jarzinho Malanga,,,18.0,2006.0,0.0,0,0,0,0,0,0,0,,0,0,0,0,0,0,0,0
GER-Bundesliga,2425,Stuttgart,Josha Vagnoman,,,23.0,2000.0,20.4,26,14,11,13,2,17,34,50.0,17,16,2,14,14,40,57,1
GER-Bundesliga,2425,Stuttgart,Julian Chabot,,,26.0,1998.0,25.2,37,24,19,15,3,15,32,46.9,17,29,19,10,38,75,135,0
GER-Bundesliga,2425,Stuttgart,Justin Diehl,,,19.0,2004.0,1.2,1,0,0,1,0,1,1,100.0,0,2,0,2,0,1,0,0
GER-Bundesliga,2425,Stuttgart,Leonidas Stergiou,,,22.0,2002.0,9.5,24,13,9,11,4,16,19,84.2,3,16,5,11,14,38,39,0
GER-Bundesliga,2425,Stuttgart,Luca Jaquez,,,21.0,2003.0,2.8,3,0,3,0,0,1,3,33.3,2,2,0,2,3,6,4,0
GER-Bundesliga,2425,Stuttgart,Maximilian Mittelstädt,,,27.0,1997.0,27.4,79,54,42,30,7,53,73,72.6,20,47,11,36,47,126,96,2
GER-Bundesliga,2425,Stuttgart,Nick Woltemade,,,22.0,2002.0,18.0,10,7,2,4,4,6,10,60.0,4,23,2,21,1,11,15,1
GER-Bundesliga,2425,Stuttgart,Nikolas Nartey,,,24.0,2000.0,0.2,0,0,0,0,0,0,0,,0,0,0,0,0,0,4,0
GER-Bundesliga,2425,Stuttgart,Pascal Stenzel,,,28.0,1996.0,3.2,3,2,1,0,2,2,5,40.0,3,5,1,4,2,5,6,0
GER-Bundesliga,2425,Stuttgart,Ramon Hendriks,,,23.0,2001.0,12.8,20,9,11,7,2,9,13,69.2,4,15,7,8,19,39,63,0
GER-Bundesliga,2425,Stuttgart,Yannik Keitel,,,24.0,2000.0,3.0,9,6,3,5,1,9,10,90.0,1,5,2,3,4,13,6,0
GER-Bundesliga,2425,Union Berlin,Alexander Schwolow,,,32.0,1992.0,6.0,0,0,0,0,0,0,0,,0,0,0,0,0,0,2,1
GER-Bundesliga,2425,Union Berlin,Aljoscha Kemlein,,,19.0,2004.0,10.2,10,4,4,5,1,5,14,35.7,9,14,3,11,6,16,15,0
GER-Bundesliga,2425,Union Berlin,Andrej Ilic,,,24.0,2000.0,10.4,2,2,0,2,0,0,6,0.0,6,7,3,4,5,7,6,1
GER-Bundesliga,2425,Union Berlin,András Schäfer,,,25.0,1999.0,17.0,52,26,23,24,5,25,41,61.0,16,33,6,27,22,74,36,0
GER-Bundesliga,2425,Union Berlin,Benedict Hollerbach,,,23.0,2001.0,28.2,43,22,8,23,12,21,51,41.2,30,35,0,35,2,45,13,1
GER-Bundesliga,2425,Union Berlin,Christopher Trimmel,,,37.0,1987.0,19.3,38,25,23,14,1,28,42,66.7,14,14,6,8,18,56,92,0
GER-Bundesliga,2425,Union Berlin,Danilho Doekhi,,,26.0,1998.0,34.0,37,24,18,16,3,13,23,56.5,10,35,16,19,44,81,169,1
GER-Bundesliga,2425,Union Berlin,David Preu,,,19.0,2004.0,1.3,1,1,0,1,0,0,2,0.0,2,4,2,2,0,1,2,0
GER-Bundesliga,2425,Union Berlin,Diogo Leite,,,25.0,1999.0,28.3,64,32,43,17,4,33,50,66.0,17,61,25,36,57,121,162,1
GER-Bundesliga,2425,Union Berlin,Frederik Rønnow,,,31.0,1992.0,28.0,0,0,0,0,0,0,1,0.0,1,0,0,0,0,0,22,2
GER-Bundesliga,2425,Union Berlin,Ivan Prtajin,,,28.0,1996.0,1.8,3,2,0,1,2,0,0,,0,2,0,2,0,3,3,0
GER-Bundesliga,2425,Union Berlin,Janik Haberer,,,30.0,1994.0,18.8,39,29,16,21,2,26,44,59.1,18,16,0,16,17,56,37,0
GER-Bundesliga,2425,Union Berlin,Jeong Woo-yeong,,,24.0,1999.0,14.0,10,7,5,5,0,3,11,27.3,8,10,1,9,11,21,11,0
GER-Bundesliga,2425,Union Berlin,Jordan Pefok,,,28.0,1996.0,10.1,11,6,6,0,5,3,7,42.9,4,9,2,7,4,15,18,0
GER-Bundesliga,2425,Union Berlin,Josip Juranović,,,28.0,1995.0,12.9,21,13,12,6,3,10,25,40.0,15,13,6,7,7,28,42,2
GER-Bundesliga,2425,Union Berlin,Jérôme Roussillon,,,31.0,1993.0,1.5,0,0,0,0,0,0,2,0.0,2,0,0,0,2,2,7,0
GER-Bundesliga,2425,Union Berlin,Kevin Vogt,,,32.0,1991.0,15.2,12,8,7,5,0,8,13,61.5,5,16,8,8,9,21,75,1
GER-Bundesliga,2425,Union Berlin,Kevin Volland,,,32.0,1992.0,0.7,0,0,0,0,0,0,0,,0,1,0,1,0,0,1,0
GER-Bundesliga,2425,Union Berlin,Leopold Querfeld,,,20.0,2003.0,19.4,25,12,21,4,0,13,18,72.2,5,25,10,15,19,44,144,2
GER-Bundesliga,2425,Union Berlin,Lucas Tousart,,,27.0,1997.0,6.2,17,9,6,9,2,5,12,41.7,7,11,4,7,7,24,27,0
GER-Bundesliga,2425,Union Berlin,László Bénes,,,26.0,1997.0,6.5,2,2,1,1,0,1,3,33.3,2,5,1,4,3,5,9,0
GER-Bundesliga,2425,Union Berlin,Marin Ljubicic,,,22.0,2002.0,3.1,2,1,0,2,0,1,3,33.3,2,2,0,2,0,2,7,0
GER-Bundesliga,2425,Union Berlin,Rani Khedira,,,30.0,1994.0,30.3,68,40,30,35,3,24,38,63.2,14,33,11,22,44,112,55,0
GER-Bundesliga,2425,Union Berlin,Robert Skov,,,28.0,1996.0,9.5,15,11,8,7,0,10,20,50.0,10,8,1,7,8,23,9,0
GER-Bundesliga,2425,Union Berlin,Robin Gosens,,,30.0,1994.0,1.0,0,0,0,0,0,0,3,0.0,3,1,0,1,1,1,2,0
GER-Bundesliga,2425,Union Berlin,Tim Skarke,,,27.0,1996.0,12.9,14,11,5,8,1,10,19,52.6,9,7,0,7,5,19,17,0
GER-Bundesliga,2425,Union Berlin,Tom Rothe,,,19.0,2004.0,18.6,45,28,27,15,3,29,51,56.9,22,41,5,36,18,63,57,1
GER-Bundesliga,2425,Union Berlin,Yorbe Vertessen,,,23.0,2001.0,8.0,6,3,3,2,1,2,8,25.0,6,6,0,6,3,9,6,0
GER-Bundesliga,2425,Werder Bremen,Amos Pieper,,,26.0,1998.0,16.6,32,17,16,11,5,21,33,63.6,12,28,17,11,24,56,98,1
GER-Bundesliga,2425,Werder Bremen,André Silva,,,28.0,1995.0,4.2,2,2,1,1,0,0,1,0.0,1,3,1,2,0,2,3,0
GER-Bundesliga,2425,Werder Bremen,Anthony Jung,,,32.0,1991.0,21.1,34,22,22,11,1,22,34,64.7,12,23,14,9,25,59,77,1
GER-Bundesliga,2425,Werder Bremen,Derrick Köhn,,,25.0,1999.0,14.9,20,10,7,10,3,10,14,71.4,4,21,4,17,10,30,26,0
GER-Bundesliga,2425,Werder Bremen,Felix Agu,,,24.0,1999.0,19.5,30,14,12,14,4,12,23,52.2,11,27,9,18,21,51,48,0
GER-Bundesliga,2425,Werder Bremen,Issa Kaboré,,,23.0,2001.0,3.4,8,4,2,5,1,4,6,66.7,2,8,2,6,2,10,7,0
GER-Bundesliga,2425,Werder Bremen,Jens Stage,,,27.0,1996.0,24.5,49,30,22,24,3,25,46,54.3,21,44,10,34,18,67,42,2
GER-Bundesliga,2425,Werder Bremen,Julián Malatini,,,23.0,2001.0,5.0,11,9,5,5,1,5,11,45.5,6,8,3,5,7,18,17,0
GER-Bundesliga,2425,Werder Bremen,Justin Njinmah,,,23.0,2000.0,10.6,6,2,1,4,1,3,5,60.0,2,5,0,5,3,9,1,0
GER-Bundesliga,2425,Werder Bremen,Keke Maximilian Topp,,,20.0,2004.0,2.8,3,1,0,2,1,1,2,50.0,1,0,0,0,1,4,4,0
GER-Bundesliga,2425,Werder Bremen,Leonardo Bittencourt,,,30.0,1993.0,10.9,25,9,15,7,3,6,18,33.3,12,8,0,8,15,40,11,0
GER-Bundesliga,2425,Werder Bremen,Marco Friedl,,,26.0,1998.0,24.0,62,42,35,26,1,38,66,57.6,28,41,24,17,34,96,130,1
GER-Bundesliga,2425,Werder Bremen,Marco Grüll,,,26.0,1998.0,13.1,12,9,1,5,6,4,17,23.5,13,14,2,12,3,15,10,0
GER-Bundesliga,2425,Werder Bremen,Marvin Ducksch,,,30.0,1994.0,26.9,10,7,3,5,2,3,14,21.4,11,10,2,8,8,18,26,3
GER-Bundesliga,2425,Werder Bremen,Michael Zetterer,,,29.0,1995.0,34.0,0,0,0,0,0,0,1,0.0,1,1,0,1,1,1,10,7
GER-Bundesliga,2425,Werder Bremen,Miloš Veljković,,,28.0,1995.0,11.4,10,5,6,3,1,7,15,46.7,8,14,9,5,2,12,47,1
GER-Bundesliga,2425,Werder Bremen,Mitchell Weiser,,,30.0,1994.0,31.9,61,40,19,34,8,28,56,50.0,28,33,3,30,22,83,61,3
GER-Bundesliga,2425,Werder Bremen,Niklas Stark,,,29.0,1995.0,23.4,33,21,20,11,2,14,21,66.7,7,41,27,14,36,69,129,1
GER-Bundesliga,2425,Werder Bremen,Oliver Burke,,,27.0,1997.0,10.1,11,4,5,1,5,4,6,66.7,2,20,0,20,2,13,6,0
GER-Bundesliga,2425,Werder Bremen,Olivier Deman,,,24.0,2000.0,0.7,6,3,2,4,0,2,7,28.6,5,3,1,2,3,9,4,0
GER-Bundesliga,2425,Werder Bremen,Romano Schmid,,,24.0,2000.0,31.5,43,25,10,22,11,24,51,47.1,27,42,3,39,11,54,9,2
GER-Bundesliga,2425,Werder Bremen,Senne Lynen,,,25.0,1999.0,30.4,72,39,36,30,6,39,69,56.5,30,56,13,43,65,137,75,5
GER-Bundesliga,2425,Werder Bremen,Skelly Alvero,,,22.0,2002.0,2.6,11,6,5,5,1,4,5,80.0,1,4,0,4,2,13,10,0
GER-Bundesliga,2425,Wolfsburg,Andreas Skov Olsen,,,24.0,1999.0,5.9,8,6,5,3,0,4,4,100.0,0,4,0,4,2,10,12,0
GER-Bundesliga,2425,Wolfsburg,Aster Vranckx,,,21.0,2002.0,6.2,11,6,3,8,0,3,9,33.3,6,14,3,11,10,21,13,0
GER-Bundesliga,2425,Wolfsburg,Bence Dárdai,,,18.0,2006.0,14.5,24,14,9,13,2,16,30,53.3,14,20,4,16,12,36,28,1
GER-Bundesliga,2425,Wolfsburg,Cedric Zesiger,,,26.0,1998.0,5.8,13,8,6,5,2,6,12,50.0,6,6,5,1,3,16,28,0
GER-Bundesliga,2425,Wolfsburg,David Odogu,,,18.0,2006.0,2.2,6,4,4,2,0,3,5,60.0,2,2,2,0,2,8,25,1
GER-Bundesliga,2425,Wolfsburg,Denis Vavro,,,28.0,1996.0,27.3,21,13,16,5,0,11,23,47.8,12,48,32,16,37,58,234,3
GER-Bundesliga,2425,Wolfsburg,Jakub Kamiński,,,22.0,2002.0,12.6,17,8,8,3,6,9,22,40.9,13,17,7,10,13,30,23,1
GER-Bundesliga,2425,Wolfsburg,Joakim Mæhle,,,27.0,1997.0,24.3,34,15,26,6,2,17,45,37.8,28,24,3,21,25,59,57,2
GER-Bundesliga,2425,Wolfsburg,Jonas Wind,,,25.0,1999.0,21.8,10,6,1,8,1,4,8,50.0,4,17,3,14,6,16,15,0
GER-Bundesliga,2425,Wolfsburg,Kamil Grabara,,,25.0,1999.0,28.7,0,0,0,0,0,0,2,0.0,2,1,0,1,0,0,16,2
GER-Bundesliga,2425,Wolfsburg,Kevin Behrens,,,33.0,1991.0,1.9,1,1,0,1,0,0,1,0.0,1,0,0,0,1,2,2,0
GER-Bundesliga,2425,Wolfsburg,Kevin Paredes,,,21.0,2003.0,1.4,3,1,3,0,0,2,3,66.7,1,2,2,0,1,4,0,0
GER-Bundesliga,2425,Wolfsburg,Kilian Fischer,,,23.0,2000.0,25.5,64,44,48,12,4,47,89,52.8,42,41,8,33,19,83,98,2
GER-Bundesliga,2425,Wolfsburg,Konstantinos Koulierakis,,,20.0,2003.0,27.4,40,20,25,13,2,25,40,62.5,15,34,14,20,33,73,147,2
GER-Bundesliga,2425,Wolfsburg,Lovro Majer,,,26.0,1998.0,3.4,2,1,0,1,1,1,5,20.0,4,5,1,4,1,3,2,1
GER-Bundesliga,2425,Wolfsburg,Lukas Nmecha,,,25.0,1998.0,5.2,2,0,1,1,0,0,1,0.0,1,3,0,3,2,4,4,0
GER-Bundesliga,2425,Wolfsburg,Mads Roerslev,,,25.0,1999.0,3.3,10,9,8,1,1,6,9,66.7,3,2,2,0,5,15,16,0
GER-Bundesliga,2425,Wolfsburg,Marius Müller,,,31.0,1993.0,5.3,0,0,0,0,0,0,0,,0,0,0,0,0,0,0,0
GER-Bundesliga,2425,Wolfsburg,Mattias Svanberg,,,25.0,1999.0,13.5,20,10,6,11,3,9,19,47.4,10,11,4,7,15,35,26,0
GER-Bundesliga,2425,Wolfsburg,Maximilian Arnold,,,30.0,1994.0,26.2,34,20,13,18,3,15,33,45.5,18,21,11,10,24,58,70,2
GER-Bundesliga,2425,Wolfsburg,Mohamed Amoura,,,24.0,2000.0,27.4,29,22,14,5,10,14,37,37.8,23,42,2,40,9,38,24,0
GER-Bundesliga,2425,Wolfsburg,Patrick Wimmer,,,23.0,2001.0,19.7,47,35,19,21,7,15,46,32.6,31,31,4,27,32,79,15,2
GER-Bundesliga,2425,Wolfsburg,Ridle Baku,,,26.0,1998.0,13.0,23,15,9,9,5,8,19,42.1,11,22,1,21,15,38,15,0
GER-Bundesliga,2425,Wolfsburg,Salih Özcan,,,26.0,1998.0,3.9,2,2,1,0,1,1,5,20.0,4,5,1,4,7,9,5,0
GER-Bundesliga,2425,Wolfsburg,Sebastiaan Bornauw,,,25.0,1999.0,8.8,9,6,4,4,1,4,8,50.0,4,14,12,2,12,21,36,0
GER-Bundesliga,2425,Wolfsburg,Tiago Tomás,,,22.0,2002.0,20.9,33,19,15,11,7,15,35,42.9,20,17,4,13,9,42,19,0
GER-Bundesliga,2425,Wolfsburg,Yannick Gerhardt,,,30.0,1994.0,16.9,28,16,13,14,1,11,30,36.7,19,32,8,24,17,45,47,0
ITA-Serie A,2425,Atalanta,Ademola Lookman,,,26.0,1997.0,25.0,32,15,9,15,8,11,19,57.9,8,19,0,19,3,35,5,1
ITA-Serie A,2425,Atalanta,Alberto Manzoni,,,19.0,2005.0,0.1,0,0,0,0,0,0,0,,0,0,0,0,0,0,0,0
ITA-Serie A,2425,Atalanta,Ben Godfrey,,,26.0,1998.0,0.3,0,0,0,0,0,0,1,0.0,1,1,1,0,0,0,0,0
ITA-Serie A,2425,Atalanta,Berat Djimsiti,,,31.0,1993.0,29.3,53,33,29,23,1,29,40,72.5,11,34,21,13,40,93,141,2
ITA-Serie A,2425,Atalanta,Charles De Ketelaere,,,23.0,2001.0,23.0,13,9,2,9,2,4,15,26.7,11,14,3,11,3,16,9,1
ITA-Serie A,2425,Atalanta,Daniel Maldini,,,22.0,2001.0,2.9,2,2,0,1,1,1,2,50.0,1,1,0,1,2,4,3,0
ITA-Serie A,2425,Atalanta,Davide Zappacosta,,,32.0,1992.0,23.0,26,16,15,5,6,20,39,51.3,19,28,6,22,11,37,32,2
ITA-Serie A,2425,Atalanta,Federico Cassa,,,18.0,2006.0,0.2,0,0,0,0,0,0,0,,0,1,0,1,0,0,0,0
ITA-Serie A,2425,Atalanta,Gianluca Scamacca,,,25.0,1999.0,0.1,0,0,0,0,0,0,0,,0,0,0,0,0,0,0,0
ITA-Serie A,2425,Atalanta,Giorgio Scalvini,,,20.0,2003.0,3.0,8,4,5,3,0,5,9,55.6,4,0,0,0,4,12,7,0
ITA-Serie A,2425,Atalanta,Ibrahim Sulemana,,,21.0,2003.0,3.1,9,4,4,5,0,2,8,25.0,6,2,0,2,0,9,1,0
ITA-Serie A,2425,Atalanta,Isak Hien,,,25.0,1999.0,25.9,48,28,27,21,0,27,44,61.4,17,31,18,13,31,79,82,2
ITA-Serie A,2425,Atalanta,Juan Cuadrado,,,36.0,1988.0,9.2,19,9,9,6,4,11,23,47.8,12,14,2,12,7,26,9,0
ITA-Serie A,2425,Atalanta,Juan Musso,,,30.0,1994.0,1.0,0,0,0,0,0,0,0,,0,0,0,0,0,0,0,0
ITA-Serie A,2425,Atalanta,Lazar Samardzic,,,22.0,2002.0,13.0,21,15,5,7,9,12,25,48.0,13,9,1,8,2,23,6,0
ITA-Serie A,2425,Atalanta,Marco Brescianini,,,24.0,2000.0,11.0,18,11,5,9,4,8,10,80.0,2,15,2,13,2,20,6,0
ITA-Serie A,2425,Atalanta,Marco Carnesecchi,,,24.0,2000.0,34.0,0,0,0,0,0,0,0,,0,1,0,1,0,0,26,2
ITA-Serie A,2425,Atalanta,Marco Palestra,,,19.0,2005.0,2.5,6,4,3,2,1,3,3,100.0,0,4,1,3,2,8,4,0
ITA-Serie A,2425,Atalanta,Mario Pašalić,,,29.0,1995.0,21.9,26,16,11,13,2,11,26,42.3,15,22,7,15,12,38,28,1
ITA-Serie A,2425,Atalanta,Marten de Roon,,,33.0,1991.0,34.0,74,48,32,38,4,30,66,45.5,36,40,7,33,47,121,67,1
ITA-Serie A,2425,Atalanta,Mateo Retegui,,,25.0,1999.0,26.5,14,9,0,9,5,3,16,18.8,13,7,0,7,4,18,17,0
ITA-Serie A,2425,Atalanta,Matteo Ruggeri,,,22.0,2002.0,19.5,39,24,15,14,10,25,39,64.1,14,30,4,26,22,61,50,1
ITA-Serie A,2425,Atalanta,Mitchel Bakker,,,24.0,2000.0,0.2,1,0,1,0,0,1,1,100.0,0,0,0,0,0,1,0,0
ITA-Serie A,2425,Atalanta,Nicolò Zaniolo,,,25.0,1999.0,4.0,0,0,0,0,0,0,2,0.0,2,0,0,0,1,1,0,0
ITA-Serie A,2425,Atalanta,Odilon Kossounou,,,23.0,2001.0,12.5,16,11,8,6,2,6,13,46.2,7,16,6,10,13,29,25,1
ITA-Serie A,2425,Atalanta,Rafael Tolói,,,33.0,1990.0,5.2,10,5,3,5,2,4,11,36.4,7,8,2,6,8,18,11,0
ITA-Serie A,2425,Atalanta,Raoul Bellanova,,,24.0,2000.0,26.7,24,14,8,13,3,13,21,61.9,8,12,3,9,18,42,45,0
ITA-Serie A,2425,Atalanta,Rui Patrício,,,36.0,1988.0,3.0,0,0,0,0,0,0,0,,0,0,0,0,0,0,3,0
ITA-Serie A,2425,Atalanta,Sead Kolašinac,,,31.0,1993.0,21.1,41,26,21,20,0,16,30,53.3,14,16,7,9,25,66,53,1
ITA-Serie A,2425,Atalanta,Stefan Posch,,,27.0,1997.0,4.3,18,11,7,8,3,8,9,88.9,1,5,1,4,4,22,13,0
ITA-Serie A,2425,Atalanta,Vanja Vlahović,,,20.0,2004.0,0.7,1,1,0,0,1,0,0,,0,0,0,0,0,1,0,0
ITA-Serie A,2425,Atalanta,Éderson,,,25.0,1999.0,32.0,52,32,19,28,5,22,34,64.7,12,30,6,24,35,87,36,1
ITA-Serie A,2425,Bologna,Benjamín Domínguez,,,20.0,2003.0,14.2,18,7,2,11,5,6,20,30.0,14,15,1,14,4,22,7,0
ITA-Serie A,2425,Bologna,Charalampos Lykogiannis,,,30.0,1993.0,11.6,23,14,14,8,1,10,20,50.0,10,10,5,5,11,34,41,1
ITA-Serie A,2425,Bologna,Dan Ndoye,,,23.0,2000.0,23.8,26,19,8,8,10,16,28,57.1,12,23,0,23,9,35,4,0
ITA-Serie A,2425,Bologna,Davide Calabria,,,27.0,1996.0,7.0,12,8,5,5,2,5,12,41.7,7,4,0,4,3,15,22,1
ITA-Serie A,2425,Bologna,Emil Holm,,,24.0,2000.0,12.6,34,21,17,14,3,20,31,64.5,11,19,4,15,10,44,51,1
ITA-Serie A,2425,Bologna,Estanis,,,20.0,2003.0,0.1,0,0,0,0,0,0,0,,0,0,0,0,0,0,0,0
ITA-Serie A,2425,Bologna,Federico Ravaglia,,,24.0,1999.0,11.7,0,0,0,0,0,0,0,,0,0,0,0,0,0,9,0
ITA-Serie A,2425,Bologna,Giovanni Fabbian,,,21.0,2003.0,11.4,10,6,1,3,6,7,13,53.8,6,7,2,5,2,12,4,0
ITA-Serie A,2425,Bologna,Jens Odgaard,,,25.0,1999.0,21.7,20,14,3,12,5,6,21,28.6,15,19,2,17,9,29,12,1
ITA-Serie A,2425,Bologna,Jesper Karlsson,,,26.0,1998.0,3.3,1,0,0,0,1,0,2,0.0,2,4,0,4,0,1,3,0
ITA-Serie A,2425,Bologna,Jhon Lucumí,,,26.0,1998.0,29.0,53,30,23,29,1,29,41,70.7,12,32,14,18,26,79,88,7
ITA-Serie A,2425,Bologna,Juan Miranda,,,24.0,2000.0,25.3,32,18,11,14,7,14,33,42.4,19,21,3,18,23,55,50,1
ITA-Serie A,2425,Bologna,Kacper Urbanski,,,19.0,2004.0,2.7,5,2,4,0,1,4,6,66.7,2,5,1,4,2,7,5,0
ITA-Serie A,2425,Bologna,Lewis Ferguson,,,24.0,1999.0,10.9,24,13,4,14,6,9,16,56.3,7,9,2,7,5,29,9,0
ITA-Serie A,2425,Bologna,Lorenzo De Silvestri,,,36.0,1988.0,11.8,11,6,7,1,3,7,16,43.8,9,12,4,8,10,21,32,0
ITA-Serie A,2425,Bologna,Martin Erlic,,,26.0,1998.0,3.7,2,0,0,2,0,1,2,50.0,1,5,4,1,2,4,9,0
ITA-Serie A,2425,Bologna,Michel Aebischer,,,27.0,1997.0,8.0,18,13,8,7,3,10,14,71.4,4,4,1,3,7,25,6,0
ITA-Serie A,2425,Bologna,Nicolò Cambiaghi,,,23.0,2000.0,6.9,16,10,6,7,3,5,10,50.0,5,9,0,9,2,18,2,0
ITA-Serie A,2425,Bologna,Nicolò Casale,,,26.0,1998.0,10.0,11,5,4,6,1,5,10,50.0,5,15,7,8,17,28,43,3
ITA-Serie A,2425,Bologna,Nikola Moro,,,26.0,1998.0,13.4,35,27,7,21,7,22,33,66.7,11,18,7,11,13,48,18,0
ITA-Serie A,2425,Bologna,Oussama El Azzouzi,,,23.0,2001.0,0.2,0,0,0,0,0,0,0,,0,0,0,0,2,2,0,0
ITA-Serie A,2425,Bologna,Remo Freuler,,,32.0,1992.0,35.6,79,40,28,40,11,33,79,41.8,46,38,4,34,38,117,57,1
ITA-Serie A,2425,Bologna,Riccardo Orsolini,,,27.0,1997.0,20.9,16,13,6,6,4,5,11,45.5,6,26,0,26,8,24,10,1
ITA-Serie A,2425,Bologna,Sam Beukema,,,25.0,1998.0,33.5,54,29,27,24,3,22,41,53.7,19,36,21,15,30,84,111,0
ITA-Serie A,2425,Bologna,Samuel Iling-Junior,,,20.0,2003.0,1.3,3,2,1,1,1,0,1,0.0,1,1,0,1,2,5,2,0
ITA-Serie A,2425,Bologna,Santiago Castro,,,19.0,2004.0,25.5,18,10,4,9,5,6,17,35.3,11,13,2,11,3,21,20,0
ITA-Serie A,2425,Bologna,Stefan Posch,,,27.0,1997.0,7.9,26,15,12,9,5,15,25,60.0,10,19,4,15,5,31,22,0
ITA-Serie A,2425,Bologna,Thijs Dallinga,,,23.0,2000.0,12.8,10,5,0,4,6,3,3,100.0,0,10,1,9,1,11,13,1
ITA-Serie A,2425,Bologna,Tommaso Pobega,,,25.0,1999.0,13.1,33,19,12,15,6,22,30,73.3,8,16,4,12,14,47,16,0
ITA-Serie A,2425,Bologna,Łukasz Skorupski,,,33.0,1991.0,26.3,1,0,1,0,0,1,3,33.3,2,0,0,0,0,1,13,2
ITA-Serie A,2425,Cagliari,Adam Obert,,,21.0,2002.0,12.0,31,18,12,17,2,16,27,59.3,11,19,7,12,23,54,48,2
ITA-Serie A,2425,Cagliari,Alen Sherri,,,26.0,1997.0,6.9,1,0,1,0,0,1,2,50.0,1,0,0,0,1,2,1,0
ITA-Serie A,2425,Cagliari,Alessandro Deiola,,,28.0,1995.0,15.9,31,20,11,17,3,10,32,31.3,22,26,12,14,13,44,38,0
ITA-Serie A,2425,Cagliari,Antoine Makoumbou,,,26.0,1998.0,23.9,42,23,28,11,3,19,25,76.0,6,26,5,21,17,59,28,0
ITA-Serie A,2425,Cagliari,Elia Caprile,,,22.0,2001.0,18.0,1,0,1,0,0,0,2,0.0,2,0,0,0,0,1,9,1
ITA-Serie A,2425,Cagliari,Florinel Coman,,,26.0,1998.0,2.9,5,3,3,1,1,2,2,100.0,0,2,0,2,1,6,3,0
ITA-Serie A,2425,Cagliari,Gabriele Zappa,,,24.0,1999.0,34.0,40,23,20,17,3,17,34,50.0,17,42,22,20,23,63,93,1
ITA-Serie A,2425,Cagliari,Gianluca Gaetano,,,24.0,2000.0,11.2,11,8,4,6,1,5,15,33.3,10,8,0,8,6,17,8,0
ITA-Serie A,2425,Cagliari,Gianluca Lapadula,,,34.0,1990.0,3.4,2,0,1,0,1,0,1,0.0,1,0,0,0,0,2,1,0
ITA-Serie A,2425,Cagliari,Giuseppe Ciocci,,,22.0,2002.0,0.1,0,0,0,0,0,0,0,,0,0,0,0,0,0,0,0
ITA-Serie A,2425,Cagliari,José Luis Palomino,,,34.0,1990.0,12.0,27,15,16,9,2,15,21,71.4,6,21,11,10,22,49,46,0
ITA-Serie A,2425,Cagliari,Kingstone Mutandwa,,,21.0,2003.0,1.4,0,0,0,0,0,0,0,,0,0,0,0,0,0,0,0
ITA-Serie A,2425,Cagliari,Leonardo Pavoletti,,,35.0,1988.0,4.9,1,0,0,1,0,0,0,,0,4,1,3,0,1,3,0
ITA-Serie A,2425,Cagliari,Mateusz Wieteska,,,27.0,1997.0,2.0,1,0,0,1,0,1,1,100.0,0,3,2,1,7,8,6,0
ITA-Serie A,2425,Cagliari,Matteo Prati,,,20.0,2003.0,6.3,10,4,2,7,1,3,11,27.3,8,5,2,3,7,17,10,1
ITA-Serie A,2425,Cagliari,Mattia Felici,,,23.0,2001.0,10.3,17,12,8,7,2,4,11,36.4,7,10,0,10,7,24,7,1
ITA-Serie A,2425,Cagliari,Michel Ndary Adopo,,,24.0,2000.0,26.8,55,32,16,31,8,15,29,51.7,14,20,5,15,27,82,25,0
ITA-Serie A,2425,Cagliari,Nadir Zortea,,,25.0,1999.0,30.1,30,14,16,12,2,14,37,37.8,23,11,0,11,19,49,47,2
ITA-Serie A,2425,Cagliari,Nicola Pintus,,,19.0,2005.0,0.0,0,0,0,0,0,0,0,,0,0,0,0,0,0,2,0
ITA-Serie A,2425,Cagliari,Nicolas Viola,,,34.0,1989.0,14.1,14,7,6,7,1,1,10,10.0,9,5,0,5,3,17,5,0
ITA-Serie A,2425,Cagliari,Paulo Azzi,,,30.0,1994.0,4.7,11,9,3,6,2,5,9,55.6,4,5,2,3,5,16,11,0
ITA-Serie A,2425,Cagliari,Roberto Piccoli,,,23.0,2001.0,34.7,13,9,2,6,5,3,12,25.0,9,12,4,8,3,16,31,0
ITA-Serie A,2425,Cagliari,Răzvan Marin,,,28.0,1996.0,15.6,22,13,8,11,3,13,25,52.0,12,7,0,7,2,24,20,2
ITA-Serie A,2425,Cagliari,Sebastiano Luperto,,,27.0,1996.0,36.0,48,27,31,16,1,18,28,64.3,10,30,15,15,33,81,161,1
ITA-Serie A,2425,Cagliari,Simone Scuffet,,,28.0,1996.0,13.0,0,0,0,0,0,0,1,0.0,1,0,0,0,0,0,8,2
ITA-Serie A,2425,Cagliari,Tommaso Augello,,,29.0,1994.0,30.1,49,28,28,17,4,30,43,69.8,13,23,8,15,16,65,109,2
ITA-Serie A,2425,Cagliari,Yerry Mina,,,29.0,1994.0,28.5,66,32,43,21,2,40,52,76.9,12,59,35,24,37,103,163,3
ITA-Serie A,2425,Cagliari,Zito Luvumbo,,,22.0,2002.0,17.8,10,6,4,3,3,6,19,31.6,13,5,0,5,4,14,4,0
ITA-Serie A,2425,Como,Alberto Cerri,,,28.0,1996.0,1.0,0,0,0,0,0,0,0,,0,2,0,2,0,0,1,0
ITA-Serie A,2425,Como,Alberto Dossena,,,25.0,1998.0,20.3,33,20,23,8,2,16,28,57.1,12,22,11,11,22,55,89,1
ITA-Serie A,2425,Como,Alberto Moreno,,,32.0,1992.0,19.2,25,11,17,8,0,12,26,46.2,14,12,3,9,14,39,40,2
ITA-Serie A,2425,Como,Alessandro Gabrielloni,,,30.0,1994.0,1.6,0,0,0,0,0,0,3,0.0,3,0,0,0,0,0,1,0
ITA-Serie A,2425,Como,Alessio Iovine,,,33.0,1991.0,4.3,5,2,2,3,0,4,10,40.0,6,7,1,6,3,8,21,1
ITA-Serie A,2425,Como,Ali Jasim,,,20.0,2004.0,0.1,1,0,1,0,0,1,1,100.0,0,0,0,0,0,1,0,0
ITA-Serie A,2425,Como,Alieu Fadera,,,22.0,2001.0,18.3,64,47,25,27,12,20,45,44.4,25,18,1,17,12,76,10,0
ITA-Serie A,2425,Como,Anastasios Douvikas,,,24.0,1999.0,6.4,3,2,0,3,0,1,4,25.0,3,3,0,3,1,4,3,0
ITA-Serie A,2425,Como,Andrea Belotti,,,30.0,1993.0,6.6,7,5,1,4,2,1,4,25.0,3,4,0,4,1,8,8,0
ITA-Serie A,2425,Como,Assane Diao,,,18.0,2005.0,13.9,25,14,9,10,6,12,28,42.9,16,8,1,7,3,28,19,0
ITA-Serie A,2425,Como,Ben Lhassine Kone,,,24.0,2000.0,0.6,2,2,1,0,1,2,3,66.7,1,0,0,0,1,3,1,0
ITA-Serie A,2425,Como,Daniele Baselli,,,32.0,1992.0,0.2,0,0,0,0,0,0,0,,0,0,0,0,1,1,1,0
ITA-Serie A,2425,Como,Dele Alli,,,28.0,1996.0,0.1,0,0,0,0,0,0,0,,0,0,0,0,0,0,0,0
ITA-Serie A,2425,Como,Edoardo Goldaniga,,,30.0,1993.0,28.1,34,21,21,8,5,13,18,72.2,5,21,10,11,33,67,102,3
ITA-Serie A,2425,Como,Emil Audero,,,27.0,1997.0,8.0,0,0,0,0,0,0,1,0.0,1,0,0,0,0,0,4,1
ITA-Serie A,2425,Como,Federico Barba,,,30.0,1993.0,4.8,2,2,1,1,0,1,4,25.0,3,2,2,0,4,6,15,0
ITA-Serie A,2425,Como,Fellipe Jack,,,18.0,2006.0,1.9,9,4,8,1,0,3,5,60.0,2,2,2,0,4,13,5,0
ITA-Serie A,2425,Como,Gabriel Strefezza,,,27.0,1997.0,29.1,57,39,20,20,17,21,55,38.2,34,24,2,22,13,70,26,0
ITA-Serie A,2425,Como,Ignace Van Der Brempt,,,22.0,2002.0,14.0,40,32,27,10,3,24,33,72.7,9,14,5,9,17,57,34,0
ITA-Serie A,2425,Como,Ivan Smolčić,,,23.0,2000.0,7.0,16,9,8,7,1,9,13,69.2,4,8,2,6,10,26,24,0
ITA-Serie A,2425,Como,Jean Butez,,,29.0,1995.0,18.5,0,0,0,0,0,0,2,0.0,2,0,0,0,0,0,18,1
ITA-Serie A,2425,Como,Jonathan Ikone,,,26.0,1998.0,6.0,15,9,4,3,8,6,11,54.5,5,5,1,4,0,15,1,1
ITA-Serie A,2425,Como,Luca Mazzitelli,,,28.0,1995.0,3.7,9,6,4,5,0,5,7,71.4,2,5,2,3,3,12,10,0
ITA-Serie A,2425,Como,Lucas Da Cunha,,,23.0,2001.0,29.0,45,25,17,19,9,20,39,51.3,19,18,3,15,17,62,30,1
ITA-Serie A,2425,Como,Marc-Oliver Kempf,,,29.0,1995.0,29.1,30,20,15,14,1,13,24,54.2,11,35,26,9,33,63,136,4
ITA-Serie A,2425,Como,Marco Sala,,,25.0,1999.0,2.9,9,6,5,3,1,5,8,62.5,3,2,0,2,1,10,9,0
ITA-Serie A,2425,Como,Matthias Braunöder,,,22.0,2002.0,3.0,10,4,6,3,1,7,11,63.6,4,3,0,3,2,12,4,1
ITA-Serie A,2425,Como,Maxence Caqueret,,,24.0,2000.0,12.1,36,21,14,18,4,20,38,52.6,18,15,1,14,7,43,4,1
ITA-Serie A,2425,Como,Máximo Perrone,,,21.0,2003.0,20.6,38,27,19,14,5,13,38,34.2,25,15,2,13,20,58,43,0
ITA-Serie A,2425,Como,Mërgim Vojvoda,,,29.0,1995.0,8.0,9,6,5,4,0,7,9,77.8,2,7,4,3,3,12,18,0
ITA-Serie A,2425,Como,Nicolás Paz,,,19.0,2004.0,29.9,51,33,18,26,7,24,51,47.1,27,49,3,46,21,72,16,0
ITA-Serie A,2425,Como,Oliver Abildgaard,,,28.0,1996.0,0.1,0,0,0,0,0,0,0,,0,1,0,1,0,0,0,0
ITA-Serie A,2425,Como,Patrick Cutrone,,,26.0,1998.0,22.7,16,11,0,10,6,7,14,50.0,7,11,0,11,5,21,7,0
ITA-Serie A,2425,Como,Pepe Reina,,,41.0,1982.0,11.5,0,0,0,0,0,0,1,0.0,1,0,0,0,0,0,3,2
ITA-Serie A,2425,Como,Sergi Roberto,,,32.0,1992.0,7.7,14,8,5,5,4,5,7,71.4,2,7,1,6,9,23,14,0
ITA-Serie A,2425,Como,Simone Verdi,,,32.0,1992.0,1.3,2,2,0,1,1,0,2,0.0,2,2,0,2,0,2,2,0
ITA-Serie A,2425,Como,Yannik Engelhardt,,,23.0,2001.0,12.9,30,12,13,13,4,16,27,59.3,11,13,6,7,11,41,27,0
ITA-Serie A,2425,Como,Álex Valle,,,20.0,2004.0,11.4,26,12,12,12,2,15,21,71.4,6,13,2,11,8,34,42,0
ITA-Serie A,2425,Empoli,Alberto Grassi,,,29.0,1995.0,24.5,39,21,16,18,5,14,22,63.6,8,22,12,10,33,72,43,1
ITA-Serie A,2425,Empoli,Ardian Ismajli,,,27.0,1996.0,27.9,30,23,21,9,0,16,20,80.0,4,35,24,11,56,86,249,3
ITA-Serie A,2425,Empoli,Christian Kouamé,,,26.0,1997.0,5.6,5,4,0,3,2,2,4,50.0,2,4,2,2,0,5,4,0
ITA-Serie A,2425,Empoli,Devis Vásquez,,,26.0,1998.0,32.0,0,0,0,0,0,0,0,,0,0,0,0,0,0,21,4
ITA-Serie A,2425,Empoli,Emmanuel Ekong,,,22.0,2002.0,2.1,4,3,0,2,2,3,3,100.0,0,2,1,1,1,5,1,0
ITA-Serie A,2425,Empoli,Emmanuel Gyasi,,,30.0,1994.0,35.7,52,29,32,14,6,24,38,63.2,14,27,9,18,11,63,77,0
ITA-Serie A,2425,Empoli,Faustino Anjorin,,,22.0,2001.0,12.4,29,13,9,14,6,9,18,50.0,9,18,3,15,13,42,20,0
ITA-Serie A,2425,Empoli,Francesco Caputo,,,36.0,1987.0,0.1,0,0,0,0,0,0,0,,0,0,0,0,0,0,0,0
ITA-Serie A,2425,Empoli,Giuseppe Pezzella,,,26.0,1997.0,32.0,55,31,28,17,10,29,57,50.9,28,32,8,24,15,70,110,2
ITA-Serie A,2425,Empoli,Ismael Konate,,,18.0,2006.0,1.3,4,2,4,0,0,2,3,66.7,1,3,2,1,0,4,1,0
ITA-Serie A,2425,Empoli,Jacopo Bacci,,,19.0,2005.0,0.3,1,0,1,0,0,1,1,100.0,0,0,0,0,1,2,1,0
ITA-Serie A,2425,Empoli,Jacopo Fazzini,,,21.0,2003.0,15.4,32,19,11,16,5,13,23,56.5,10,13,1,12,6,38,24,0
ITA-Serie A,2425,Empoli,Jacopo Seghetti,,,19.0,2005.0,1.0,0,0,0,0,0,0,0,,0,0,0,0,0,0,0,0
ITA-Serie A,2425,Empoli,Junior Sambia,,,27.0,1996.0,4.3,14,10,3,6,5,11,11,100.0,0,3,0,3,2,16,5,0
ITA-Serie A,2425,Empoli,Liam Henderson,,,28.0,1996.0,26.0,42,22,17,22,3,22,53,41.5,31,19,5,14,15,57,42,0
ITA-Serie A,2425,Empoli,Liberato Cacace,,,23.0,2000.0,24.8,37,25,20,13,4,22,31,71.0,9,26,9,17,22,59,59,0
ITA-Serie A,2425,Empoli,Lorenzo Colombo,,,22.0,2002.0,24.8,31,14,7,16,8,7,21,33.3,14,33,2,31,2,33,16,1
ITA-Serie A,2425,Empoli,Lorenzo Tosto,,,18.0,2006.0,0.0,0,0,0,0,0,0,0,,0,0,0,0,0,0,0,0
ITA-Serie A,2425,Empoli,Luca Marianucci,,,20.0,2004.0,11.9,28,12,17,11,0,11,19,57.9,8,16,8,8,19,47,63,1
ITA-Serie A,2425,Empoli,Marco Silvestri,,,33.0,1991.0,5.0,0,0,0,0,0,0,2,0.0,2,0,0,0,0,0,3,1
ITA-Serie A,2425,Empoli,Mattia De Sciglio,,,31.0,1992.0,8.5,18,13,10,8,0,14,17,82.4,3,10,3,7,8,26,35,1
ITA-Serie A,2425,Empoli,Mattia Viti,,,22.0,2002.0,28.6,65,45,42,20,3,34,52,65.4,18,41,18,23,48,113,128,4
ITA-Serie A,2425,Empoli,Nicolas Haas,,,28.0,1996.0,3.2,11,8,4,5,2,5,9,55.6,4,2,1,1,4,15,6,0
ITA-Serie A,2425,Empoli,Ola Solbakken,,,25.0,1998.0,8.4,7,4,0,6,1,3,6,50.0,3,0,0,0,2,9,8,0
ITA-Serie A,2425,Empoli,Petar Stojanović,,,28.0,1995.0,0.0,0,0,0,0,0,0,0,,0,0,0,0,0,0,0,0
ITA-Serie A,2425,Empoli,Pietro Pellegri,,,23.0,2001.0,4.6,7,2,0,6,1,2,4,50.0,2,2,0,2,0,7,3,0
ITA-Serie A,2425,Empoli,Saba Goglichidze,,,20.0,2004.0,28.2,64,37,36,25,3,25,51,49.0,26,36,17,19,33,97,97,3
ITA-Serie A,2425,Empoli,Sebastian Walukiewicz,,,24.0,2000.0,2.0,1,0,1,0,0,0,1,0.0,1,3,3,0,1,2,15,0
ITA-Serie A,2425,Empoli,Sebastiano Esposito,,,22.0,2002.0,25.9,57,29,15,31,11,18,35,51.4,17,20,2,18,12,69,14,0
ITA-Serie A,2425,Empoli,Szymon Żurkowski,,,26.0,1997.0,1.2,6,4,2,4,0,4,4,100.0,0,3,0,3,1,7,2,0
ITA-Serie A,2425,Empoli,Thomas Campaniello,,,16.0,2008.0,0.3,0,0,0,0,0,0,2,0.0,2,0,0,0,0,0,0,0
ITA-Serie A,2425,Empoli,Tyronne Ebuehi,,,28.0,1995.0,0.8,3,2,1,2,0,1,1,100.0,0,1,0,1,2,5,0,0
ITA-Serie A,2425,Empoli,Viktor Kovalenko,,,28.0,1996.0,0.9,2,1,0,2,0,0,1,0.0,1,0,0,0,0,2,0,0
ITA-Serie A,2425,Empoli,Youssef Maleh,,,25.0,1998.0,16.8,45,23,17,23,5,17,34,50.0,17,25,6,19,16,61,25,0
ITA-Serie A,2425,Fiorentina,Albert Guðmundsson,,,27.0,1997.0,14.1,9,5,2,4,3,7,17,41.2,10,5,0,5,6,15,9,1
ITA-Serie A,2425,Fiorentina,Alessandro Bianco,,,21.0,2002.0,0.2,0,0,0,0,0,0,1,0.0,1,0,0,0,0,0,0,0
ITA-Serie A,2425,Fiorentina,Amir Richardson,,,22.0,2002.0,11.4,30,13,13,15,2,9,21,42.9,12,14,1,13,6,36,29,1
ITA-Serie A,2425,Fiorentina,Andrea Colpani,,,25.0,1999.0,15.9,15,9,5,7,3,4,12,33.3,8,7,0,7,8,23,10,0
ITA-Serie A,2425,Fiorentina,Antonín Barák,,,29.0,1994.0,0.6,2,0,0,2,0,0,2,0.0,2,1,1,0,0,2,0,0
ITA-Serie A,2425,Fiorentina,Cher Ndour,,,20.0,2004.0,4.5,4,1,2,1,1,2,10,20.0,8,5,1,4,2,6,7,1
ITA-Serie A,2425,Fiorentina,Christian Kouamé,,,26.0,1997.0,6.9,13,8,4,4,5,0,3,0.0,3,3,1,2,2,15,10,0
ITA-Serie A,2425,Fiorentina,Cristiano Biraghi,,,31.0,1992.0,4.8,4,4,1,3,0,2,7,28.6,5,2,0,2,4,8,11,0
ITA-Serie A,2425,Fiorentina,Danilo Cataldi,,,29.0,1994.0,19.0,25,16,13,10,2,14,27,51.9,13,17,8,9,22,47,35,0
ITA-Serie A,2425,Fiorentina,David de Gea,,,33.0,1990.0,34.0,1,0,1,0,0,1,1,100.0,0,0,0,0,0,1,12,0
ITA-Serie A,2425,Fiorentina,Dodô,,,25.0,1998.0,33.6,44,29,25,11,8,25,49,51.0,24,22,5,17,34,78,58,2
ITA-Serie A,2425,Fiorentina,Edoardo Bove,,,22.0,2002.0,9.3,24,17,7,14,3,14,28,50.0,14,12,0,12,6,30,8,0
ITA-Serie A,2425,Fiorentina,Fabiano Parisi,,,23.0,2000.0,11.7,27,17,11,12,4,12,21,57.1,9,14,2,12,17,44,17,0
ITA-Serie A,2425,Fiorentina,Jonathan Ikone,,,26.0,1998.0,3.7,5,2,3,2,0,2,4,50.0,2,3,0,3,1,6,1,0
ITA-Serie A,2425,Fiorentina,Luca Ranieri,,,25.0,1999.0,33.1,42,24,28,12,2,20,25,80.0,5,47,32,15,27,69,154,1
ITA-Serie A,2425,Fiorentina,Lucas Beltrán,,,23.0,2001.0,20.7,23,10,10,7,6,7,21,33.3,14,15,2,13,5,28,14,0
ITA-Serie A,2425,Fiorentina,Lucas Martínez Quarta,,,28.0,1996.0,3.9,12,7,9,3,0,8,13,61.5,5,5,2,3,3,15,25,1
ITA-Serie A,2425,Fiorentina,Maat Daniel Caprini,,,18.0,2006.0,0.1,0,0,0,0,0,0,0,,0,0,0,0,0,0,0,0
ITA-Serie A,2425,Fiorentina,Marin Pongračić,,,26.0,1997.0,14.4,18,13,13,4,1,7,11,63.6,4,14,6,8,12,30,69,2
ITA-Serie A,2425,Fiorentina,Matias Moreno,,,20.0,2003.0,1.6,8,8,5,3,0,4,4,100.0,0,5,1,4,1,9,9,0
ITA-Serie A,2425,Fiorentina,Michael Folorunsho,,,26.0,1998.0,7.2,19,12,9,6,4,8,20,40.0,12,9,1,8,4,23,10,0
ITA-Serie A,2425,Fiorentina,Michael Kayode,,,20.0,2004.0,1.4,1,1,1,0,0,0,0,,0,3,1,2,2,3,7,0
ITA-Serie A,2425,Fiorentina,Moise Kean,,,24.0,2000.0,29.1,7,5,1,2,4,3,4,75.0,1,12,0,12,5,12,26,1
ITA-Serie A,2425,Fiorentina,Nicolò Fagioli,,,23.0,2001.0,10.7,19,10,8,9,2,9,22,40.9,13,11,2,9,5,24,12,2
ITA-Serie A,2425,Fiorentina,Nicolò Zaniolo,,,25.0,1999.0,3.8,3,1,1,2,0,0,4,0.0,4,2,1,1,0,3,2,0
ITA-Serie A,2425,Fiorentina,Pablo Marí,,,30.0,1993.0,12.2,14,9,11,3,0,6,11,54.5,5,19,14,5,25,39,94,0
ITA-Serie A,2425,Fiorentina,Pietro Comuzzo,,,19.0,2005.0,23.4,43,21,29,11,3,23,29,79.3,6,35,22,13,29,72,113,4
ITA-Serie A,2425,Fiorentina,Pietro Terracciano,,,34.0,1990.0,3.0,0,0,0,0,0,0,0,,0,0,0,0,0,0,0,0
ITA-Serie A,2425,Fiorentina,Riccardo Sottil,,,25.0,1999.0,9.3,5,4,3,1,1,3,4,75.0,1,1,0,1,4,9,3,0
ITA-Serie A,2425,Fiorentina,Robin Gosens,,,30.0,1994.0,27.0,56,31,31,17,8,25,44,56.8,19,34,11,23,18,74,91,0
ITA-Serie A,2425,Fiorentina,Rolando Mandragora,,,27.0,1997.0,20.6,23,13,9,12,2,14,31,45.2,17,22,7,15,15,38,54,1
ITA-Serie A,2425,Fiorentina,Sofyan Amrabat,,,27.0,1996.0,2.0,3,2,1,2,0,2,2,100.0,0,1,1,0,0,3,2,0
ITA-Serie A,2425,Fiorentina,Tommaso Rubino,,,17.0,2006.0,0.1,0,0,0,0,0,0,1,0.0,1,0,0,0,0,0,0,0
ITA-Serie A,2425,Fiorentina,Yacine Adli,,,24.0,2000.0,13.5,32,19,11,16,5,17,39,43.6,22,13,1,12,6,38,19,0
ITA-Serie A,2425,Genoa,Aarón Martín,,,27.0,1997.0,34.3,71,47,41,26,4,33,51,64.7,18,33,11,22,19,90,73,1
ITA-Serie A,2425,Genoa,Alan Matturro,,,19.0,2004.0,10.0,11,6,6,5,0,3,14,21.4,11,10,3,7,14,25,38,0
ITA-Serie A,2425,Genoa,Alessandro Marcandalli,,,21.0,2002.0,0.5,1,0,1,0,0,0,0,,0,0,0,0,0,1,2,0
ITA-Serie A,2425,Genoa,Alessandro Vogliacco,,,25.0,1998.0,7.9,15,3,7,7,1,10,12,83.3,2,11,7,4,9,24,20,0
ITA-Serie A,2425,Genoa,Alessandro Zanoli,,,23.0,2000.0,19.0,29,20,11,14,4,10,23,43.5,13,20,3,17,12,41,40,0
ITA-Serie A,2425,Genoa,Andrea Pinamonti,,,25.0,1999.0,31.7,10,6,0,7,3,2,8,25.0,6,16,4,12,1,11,28,2
ITA-Serie A,2425,Genoa,Benjamin Siegrist,,,32.0,1992.0,1.7,0,0,0,0,0,0,0,,0,0,0,0,1,1,1,0
ITA-Serie A,2425,Genoa,Brooke Norton-Cuffy,,,20.0,2004.0,8.0,12,7,9,3,0,9,11,81.8,2,12,2,10,3,15,12,0
ITA-Serie A,2425,Genoa,Caleb Ekuban,,,30.0,1994.0,6.2,3,3,1,1,1,1,1,100.0,0,4,1,3,1,4,6,0
ITA-Serie A,2425,Genoa,Daniele Sommariva,,,27.0,1997.0,0.3,0,0,0,0,0,0,0,,0,0,0,0,0,0,1,0
ITA-Serie A,2425,Genoa,David Akpan Ankeye,,,22.0,2002.0,0.5,0,0,0,0,0,0,1,0.0,1,0,0,0,0,0,1,0
ITA-Serie A,2425,Genoa,Emil Bohinen,,,25.0,1999.0,1.8,4,4,3,0,1,2,5,40.0,3,2,0,2,1,5,6,0
ITA-Serie A,2425,Genoa,Fabio Miretti,,,20.0,2003.0,18.6,28,15,6,14,8,18,33,54.5,15,20,1,19,7,35,13,2
ITA-Serie A,2425,Genoa,Federico Accornero,,,20.0,2004.0,0.1,0,0,0,0,0,0,0,,0,0,0,0,0,0,0,0
ITA-Serie A,2425,Genoa,Filippo Melegoni,,,25.0,1999.0,1.0,1,1,1,0,0,0,4,0.0,4,0,0,0,0,1,2,0
ITA-Serie A,2425,Genoa,Gastón Pereiro,,,29.0,1995.0,0.3,1,0,0,1,0,1,1,100.0,0,0,0,0,0,1,1,0
ITA-Serie A,2425,Genoa,Honest Ahanor,,,16.0,2008.0,3.0,7,5,2,3,2,7,10,70.0,3,4,0,4,1,8,9,0
ITA-Serie A,2425,Genoa,Jean Onana,,,24.0,2000.0,3.4,12,6,2,10,0,5,9,55.6,4,6,1,5,4,16,8,1
ITA-Serie A,2425,Genoa,Jeff Ekhator,,,17.0,2006.0,8.5,7,4,4,1,2,4,9,44.4,5,10,1,9,2,9,5,0
ITA-Serie A,2425,Genoa,Johan Vásquez,,,25.0,1998.0,33.8,56,31,24,27,5,26,44,59.1,18,59,31,28,50,106,150,1
ITA-Serie A,2425,Genoa,Junior Messias,,,33.0,1991.0,9.4,13,7,6,6,1,3,10,30.0,7,8,2,6,6,19,20,0
ITA-Serie A,2425,Genoa,Koni De Winter,,,22.0,2002.0,23.7,33,19,21,8,4,17,25,68.0,8,11,7,4,25,58,118,3
ITA-Serie A,2425,Genoa,Lior Kasa,,,18.0,2005.0,2.6,4,4,2,2,0,2,5,40.0,3,4,1,3,3,7,5,0
ITA-Serie A,2425,Genoa,Lorenzo Venturino,,,18.0,2006.0,1.9,5,3,4,0,1,3,6,50.0,3,3,0,3,0,5,5,0
ITA-Serie A,2425,Genoa,Mario Balotelli,,,33.0,1990.0,0.7,0,0,0,0,0,0,0,,0,0,0,0,0,0,1,0
ITA-Serie A,2425,Genoa,Mattia Bani,,,30.0,1993.0,16.7,19,10,11,6,2,7,11,63.6,4,13,8,5,22,41,85,2
ITA-Serie A,2425,Genoa,Maxwel Cornet,,,27.0,1996.0,2.7,2,1,1,0,1,0,1,0.0,1,1,1,0,2,4,2,0
ITA-Serie A,2425,Genoa,Milan Badelj,,,35.0,1989.0,16.4,29,16,14,10,5,15,35,42.9,20,19,7,12,20,49,43,0
ITA-Serie A,2425,Genoa,Morten Frendrup,,,23.0,2001.0,34.5,102,61,23,52,27,34,78,43.6,44,62,16,46,47,149,57,0
ITA-Serie A,2425,Genoa,Morten Thorsby,,,28.0,1996.0,21.1,49,30,19,20,10,17,29,58.6,12,22,1,21,5,54,28,1
ITA-Serie A,2425,Genoa,Nicola Leali,,,31.0,1993.0,29.0,0,0,0,0,0,0,0,,0,0,0,0,0,0,14,1
ITA-Serie A,2425,Genoa,Patrizio Masini,,,23.0,2001.0,17.1,54,29,18,26,10,19,40,47.5,21,26,8,18,15,69,37,0
ITA-Serie A,2425,Genoa,Pierluigi Gollini,,,29.0,1995.0,7.0,0,0,0,0,0,0,0,,0,1,0,1,0,0,2,1
ITA-Serie A,2425,Genoa,Ruslan Malinovskyi,,,31.0,1993.0,4.3,12,8,4,7,1,3,6,50.0,3,2,0,2,1,13,4,0
ITA-Serie A,2425,Genoa,Sebastian Otoa,,,20.0,2004.0,2.0,1,0,1,0,0,1,2,50.0,1,1,1,0,3,4,14,0
ITA-Serie A,2425,Genoa,Stefano Sabelli,,,31.0,1993.0,22.9,58,31,27,25,6,20,52,38.5,32,28,7,21,22,80,65,0
ITA-Serie A,2425,Genoa,Vitinha,,,24.0,2000.0,14.8,23,8,12,6,5,11,30,36.7,19,14,2,12,12,35,22,0
ITA-Serie A,2425,Hellas Verona,Abdou Harroui,,,26.0,1998.0,5.1,9,6,6,3,0,4,4,100.0,0,5,0,5,2,11,5,0
ITA-Serie A,2425,Hellas Verona,Alphadjo Cissè,,,17.0,2006.0,0.1,0,0,0,0,0,0,0,,0,0,0,0,0,0,0,0
ITA-Serie A,2425,Hellas Verona,Amin Sarr,,,23.0,2001.0,21.2,22,12,3,8,11,5,10,50.0,5,18,3,15,3,25,14,0
ITA-Serie A,2425,Hellas Verona,Antoine Bernede,,,25.0,1999.0,6.6,15,8,4,9,2,10,16,62.5,6,6,1,5,5,20,3,0
ITA-Serie A,2425,Hellas Verona,Casper Tengstedt,,,24.0,2000.0,16.9,7,5,0,5,2,4,9,44.4,5,5,1,4,4,11,29,0
ITA-Serie A,2425,Hellas Verona,Cheikh Tidiane Niasse,,,24.0,2000.0,8.4,18,15,6,12,0,10,19,52.6,9,17,4,13,17,35,17,2
ITA-Serie A,2425,Hellas Verona,Dailon Livramento,,,23.0,2001.0,10.4,15,11,2,7,6,7,13,53.8,6,10,2,8,3,18,9,0
ITA-Serie A,2425,Hellas Verona,Daniel Bandeira,,,24.0,2000.0,4.5,4,0,1,3,0,3,6,50.0,3,2,1,1,6,10,8,0
ITA-Serie A,2425,Hellas Verona,Daniel Mosquera,,,24.0,1999.0,15.3,11,8,3,5,3,1,15,6.7,14,11,1,10,2,13,10,0
ITA-Serie A,2425,Hellas Verona,Daniel Oyegoke,,,21.0,2003.0,1.1,2,2,1,0,1,1,1,100.0,0,1,0,1,1,3,7,0
ITA-Serie A,2425,Hellas Verona,Daniele Ghilardi,,,21.0,2003.0,22.5,44,29,27,17,0,25,41,61.0,16,29,15,14,30,74,106,0
ITA-Serie A,2425,Hellas Verona,Darko Lazović,,,33.0,1990.0,16.2,21,10,5,14,2,11,28,39.3,17,19,3,16,11,32,39,0
ITA-Serie A,2425,Hellas Verona,Davide Faraoni,,,32.0,1991.0,2.9,10,9,5,5,0,3,9,33.3,6,7,3,4,2,12,12,1
ITA-Serie A,2425,Hellas Verona,Diego Coppola,,,20.0,2003.0,32.5,66,36,48,14,4,28,40,70.0,12,44,24,20,72,138,194,2
ITA-Serie A,2425,Hellas Verona,Domagoj Bradarić,,,24.0,1999.0,21.5,36,28,21,11,4,18,29,62.1,11,17,4,13,15,51,49,1
ITA-Serie A,2425,Hellas Verona,Faride Alidou,,,23.0,2001.0,0.8,0,0,0,0,0,0,0,,0,1,0,1,1,1,3,1
ITA-Serie A,2425,Hellas Verona,Flavius Daniliuc,,,23.0,2001.0,11.2,26,21,14,9,3,15,24,62.5,9,10,3,7,7,33,27,0
ITA-Serie A,2425,Hellas Verona,Giangiacomo Magnani,,,28.0,1995.0,11.8,20,15,14,6,0,7,7,100.0,0,16,9,7,17,37,73,1
ITA-Serie A,2425,Hellas Verona,Grigoris Kastanos,,,26.0,1998.0,9.7,23,16,8,7,8,9,21,42.9,12,17,2,15,7,30,8,0
ITA-Serie A,2425,Hellas Verona,Jackson Tchatchoua,,,22.0,2001.0,35.2,50,31,34,13,3,28,43,65.1,15,21,9,12,14,64,75,2
ITA-Serie A,2425,Hellas Verona,Junior Ajayi,,,19.0,2004.0,0.1,0,0,0,0,0,0,0,,0,0,0,0,0,0,0,0
ITA-Serie A,2425,Hellas Verona,Lorenzo Montipò,,,28.0,1996.0,36.0,1,0,1,0,0,1,4,25.0,3,0,0,0,0,1,24,4
ITA-Serie A,2425,Hellas Verona,Martin Frese,,,26.0,1998.0,6.1,18,11,7,10,1,7,13,53.8,6,5,1,4,8,26,16,1
ITA-Serie A,2425,Hellas Verona,Mathis Lambourde,,,18.0,2006.0,1.0,3,1,2,1,0,1,3,33.3,2,3,0,3,0,3,1,0
ITA-Serie A,2425,Hellas Verona,Nicolás Valentini,,,23.0,2001.0,12.5,35,23,22,12,1,20,31,64.5,11,15,7,8,15,50,97,0
ITA-Serie A,2425,Hellas Verona,Ondrej Duda,,,29.0,1994.0,26.6,46,27,21,22,3,29,64,45.3,35,28,9,19,31,77,30,4
ITA-Serie A,2425,Hellas Verona,Paweł Dawidowicz,,,29.0,1995.0,20.5,45,24,20,22,3,18,27,66.7,9,16,6,10,20,65,70,2
ITA-Serie A,2425,Hellas Verona,Reda Belahyane,,,20.0,2004.0,18.4,36,26,16,13,7,13,17,76.5,4,20,9,11,10,46,22,1
ITA-Serie A,2425,Hellas Verona,Simone Perilli,,,29.0,1995.0,2.0,0,0,0,0,0,0,0,,0,0,0,0,0,0,1,0
ITA-Serie A,2425,Hellas Verona,Suat Serdar,,,27.0,1997.0,15.3,35,22,12,19,4,10,26,38.5,16,19,4,15,8,43,21,0
ITA-Serie A,2425,Hellas Verona,Tomáš Suslov,,,22.0,2002.0,23.1,54,38,23,24,7,23,72,31.9,49,30,2,28,18,72,17,1
ITA-Serie A,2425,Hellas Verona,Yllan Okou,,,21.0,2002.0,0.0,0,0,0,0,0,0,0,,0,1,0,1,0,0,0,0
ITA-Serie A,2425,Inter,Alessandro Bastoni,,,25.0,1999.0,25.9,46,23,26,14,6,20,30,66.7,10,25,13,12,21,67,52,1
ITA-Serie A,2425,Inter,Benjamin Pavard,,,28.0,1996.0,17.6,29,16,12,12,5,18,25,72.0,7,16,12,4,16,45,52,0
ITA-Serie A,2425,Inter,Carlos Augusto,,,25.0,1999.0,18.1,29,14,12,11,6,12,19,63.2,7,21,9,12,9,38,50,0
ITA-Serie A,2425,Inter,Davide Frattesi,,,24.0,1999.0,12.9,17,8,6,10,1,10,18,55.6,8,12,4,8,5,22,14,1
ITA-Serie A,2425,Inter,Denzel Dumfries,,,28.0,1996.0,20.7,25,15,12,9,4,14,27,51.9,13,31,8,23,6,31,26,1
ITA-Serie A,2425,Inter,Federico Dimarco,,,26.0,1997.0,23.8,25,14,10,12,3,10,19,52.6,9,24,4,20,14,39,33,2
ITA-Serie A,2425,Inter,Francesco Acerbi,,,36.0,1988.0,19.0,23,19,16,7,0,11,17,64.7,6,22,16,6,26,49,81,0
ITA-Serie A,2425,Inter,Hakan Çalhanoğlu,,,30.0,1994.0,20.9,43,22,7,23,13,21,36,58.3,15,17,8,9,17,60,24,0
ITA-Serie A,2425,Inter,Henrikh Mkhitaryan,,,35.0,1989.0,25.9,43,24,17,16,10,20,45,44.4,25,29,5,24,16,59,41,0
ITA-Serie A,2425,Inter,Joaquín Correa,,,29.0,1994.0,8.1,11,5,4,7,0,4,13,30.8,9,3,0,3,0,11,6,0
ITA-Serie A,2425,Inter,Josep Martinez,,,26.0,1998.0,5.0,0,0,0,0,0,0,0,,0,0,0,0,0,0,0,0
ITA-Serie A,2425,Inter,Kristjan Asllani,,,22.0,2002.0,10.9,14,3,8,4,2,8,22,36.4,14,8,1,7,9,23,13,1
ITA-Serie A,2425,Inter,Lautaro Martínez,,,26.0,1997.0,27.5,30,16,10,12,8,13,25,52.0,12,21,3,18,10,40,15,0
ITA-Serie A,2425,Inter,Luka Topalović,,,18.0,2006.0,0.1,1,1,0,1,0,0,0,,0,0,0,0,0,1,0,0
ITA-Serie A,2425,Inter,Marcus Thuram,,,26.0,1997.0,24.4,18,8,7,5,6,3,14,21.4,11,16,3,13,3,21,15,0
ITA-Serie A,2425,Inter,Marko Arnautović,,,35.0,1989.0,5.9,7,5,1,3,3,3,5,60.0,2,3,0,3,1,8,1,0
ITA-Serie A,2425,Inter,Matteo Darmian,,,34.0,1989.0,19.8,28,17,12,12,4,14,25,56.0,11,14,6,8,10,38,39,0
ITA-Serie A,2425,Inter,Mehdi Taremi,,,32.0,1992.0,9.0,7,1,2,2,3,1,4,25.0,3,11,2,9,0,7,11,0
ITA-Serie A,2425,Inter,Nicola Zalewski,,,22.0,2002.0,4.8,7,4,3,2,2,4,6,66.7,2,5,1,4,2,9,5,1
ITA-Serie A,2425,Inter,Nicolò Barella,,,27.0,1997.0,27.3,50,31,19,20,11,26,59,44.1,33,26,3,23,12,62,16,1
ITA-Serie A,2425,Inter,Piotr Zieliński,,,30.0,1994.0,10.9,14,10,6,7,1,6,13,46.2,7,10,5,5,6,20,13,1
ITA-Serie A,2425,Inter,Stefan de Vrij,,,32.0,1992.0,18.2,18,11,12,5,1,9,12,75.0,3,19,11,8,22,40,89,0
ITA-Serie A,2425,Inter,Tajon Buchanan,,,25.0,1999.0,1.1,3,0,2,0,1,1,2,50.0,1,0,0,0,0,3,3,0
ITA-Serie A,2425,Inter,Tomás Palacios,,,21.0,2003.0,0.1,0,0,0,0,0,0,0,,0,0,0,0,1,1,0,0
ITA-Serie A,2425,Inter,Yann Aurel Bisseck,,,23.0,2000.0,17.3,17,11,11,4,2,11,16,68.8,5,23,12,11,17,34,64,1
ITA-Serie A,2425,Inter,Yann Sommer,,,35.0,1988.0,32.0,0,0,0,0,0,0,0,,0,0,0,0,0,0,13,1
ITA-Serie A,2425,Juventus,Alberto costa,,,20.0,2003.0,4.0,14,10,7,5,2,7,9,77.8,2,5,1,4,4,18,14,0
ITA-Serie A,2425,Juventus,Andrea Cambiaso,,,24.0,2000.0,24.7,46,30,27,13,6,27,44,61.4,17,24,4,20,16,62,34,5
ITA-Serie A,2425,Juventus,Danilo,,,33.0,1991.0,6.5,10,4,7,2,1,5,10,50.0,5,4,3,1,9,19,21,1
ITA-Serie A,2425,Juventus,Diego Pugno,,,18.0,2006.0,0.1,0,0,0,0,0,0,0,,0,0,0,0,0,0,0,0
ITA-Serie A,2425,Juventus,Douglas Luiz,,,26.0,1998.0,5.9,13,8,7,5,1,6,9,66.7,3,5,2,3,4,17,5,0
ITA-Serie A,2425,Juventus,Dušan Vlahović,,,24.0,2000.0,19.8,4,2,0,1,3,1,5,20.0,4,7,3,4,1,5,9,3
ITA-Serie A,2425,Juventus,Federico Gatti,,,26.0,1998.0,24.4,28,23,18,8,2,14,24,58.3,10,27,18,9,18,46,76,2
ITA-Serie A,2425,Juventus,Francisco Conceição,,,21.0,2002.0,14.9,23,14,6,9,8,13,30,43.3,17,7,0,7,6,29,6,0
ITA-Serie A,2425,Juventus,Gleison Bremer,,,27.0,1997.0,6.0,15,7,9,5,1,4,5,80.0,1,15,11,4,6,21,16,0
ITA-Serie A,2425,Juventus,Jonas Rouhi,,,20.0,2004.0,2.3,4,1,1,3,0,0,1,0.0,1,2,0,2,3,7,2,0
ITA-Serie A,2425,Juventus,Juan David Cabal,,,23.0,2001.0,5.1,10,4,7,3,0,8,12,66.7,4,2,0,2,2,12,14,1
ITA-Serie A,2425,Juventus,Kenan Yıldız,,,19.0,2005.0,26.7,54,30,13,26,15,18,32,56.3,14,25,0,25,5,59,13,3
ITA-Serie A,2425,Juventus,Khéphren Thuram,,,23.0,2001.0,25.8,44,21,16,24,4,18,32,56.3,14,32,10,22,14,58,39,2
ITA-Serie A,2425,Juventus,Lloyd Kelly,,,25.0,1998.0,11.3,15,11,5,9,1,7,9,77.8,2,11,6,5,2,17,56,3
ITA-Serie A,2425,Juventus,Lorenzo Anghelè,,,19.0,2005.0,0.1,0,0,0,0,0,0,0,,0,0,0,0,0,0,0,0
ITA-Serie A,2425,Juventus,Manuel Locatelli,,,26.0,1998.0,31.4,72,49,29,35,8,32,56,57.1,24,58,20,38,23,95,77,0
ITA-Serie A,2425,Juventus,Mattia Perin,,,31.0,1992.0,5.0,0,0,0,0,0,0,0,,0,0,0,0,0,0,2,0
ITA-Serie A,2425,Juventus,Michele Di Gregorio,,,27.0,1997.0,33.0,0,0,0,0,0,0,0,,0,0,0,0,1,1,14,0
ITA-Serie A,2425,Juventus,Nicolás González,,,26.0,1998.0,19.4,24,13,10,9,5,9,25,36.0,16,16,4,12,9,33,37,2
ITA-Serie A,2425,Juventus,Nicolò Fagioli,,,23.0,2001.0,6.3,14,10,7,6,1,6,9,66.7,3,4,0,4,2,16,5,0
ITA-Serie A,2425,Juventus,Nicolò Savona,,,21.0,2003.0,19.2,29,13,19,9,1,13,25,52.0,12,12,3,9,11,40,38,0
ITA-Serie A,2425,Juventus,Pierre Kalulu,,,24.0,2000.0,26.0,41,25,29,9,3,18,24,75.0,6,27,15,12,17,58,68,1
ITA-Serie A,2425,Juventus,Randal Kolo Muani,,,25.0,1998.0,12.9,11,7,3,5,3,4,5,80.0,1,8,0,8,4,15,2,0
ITA-Serie A,2425,Juventus,Renato Veiga,,,21.0,2003.0,12.1,17,12,7,9,1,9,14,64.3,5,17,13,4,19,36,81,0
ITA-Serie A,2425,Juventus,Samuel Mbangula,,,20.0,2004.0,7.9,15,10,7,6,2,7,13,53.8,6,7,0,7,3,18,4,0
ITA-Serie A,2425,Juventus,Teun Koopmeiners,,,26.0,1998.0,22.2,32,16,6,19,7,10,30,33.3,20,36,14,22,8,40,26,2
ITA-Serie A,2425,Juventus,Timothy Weah,,,24.0,2000.0,18.2,36,19,15,13,8,14,25,56.0,11,25,4,21,14,50,27,2
ITA-Serie A,2425,Juventus,Vasilije Adžić,,,18.0,2006.0,0.5,2,2,0,1,1,0,1,0.0,1,0,0,0,0,2,0,0
ITA-Serie A,2425,Juventus,Weston McKennie,,,25.0,1998.0,25.7,33,12,18,11,4,13,22,59.1,9,28,8,20,14,47,37,0
ITA-Serie A,2425,Lazio,Adam Marušić,,,31.0,1992.0,26.0,32,20,18,12,2,18,30,60.0,12,18,8,10,16,48,61,0
ITA-Serie A,2425,Lazio,Alessio Romagnoli,,,29.0,1995.0,29.7,48,29,20,26,2,22,27,81.5,5,33,17,16,26,74,118,1
ITA-Serie A,2425,Lazio,Arijon Ibrahimović,,,18.0,2005.0,0.1,0,0,0,0,0,0,0,,0,0,0,0,0,0,0,0
ITA-Serie A,2425,Lazio,Boulaye Dia,,,27.0,1996.0,24.2,22,10,5,12,5,7,16,43.8,9,12,1,11,6,28,16,1
ITA-Serie A,2425,Lazio,Christos Mandas,,,22.0,2001.0,9.0,0,0,0,0,0,0,0,,0,0,0,0,0,0,4,0
ITA-Serie A,2425,Lazio,Elseid Hysaj,,,30.0,1994.0,4.7,11,6,6,5,0,3,3,100.0,0,5,2,3,5,16,21,0
ITA-Serie A,2425,Lazio,Fisayo Dele-Bashiru,,,23.0,2001.0,10.5,10,6,3,3,4,2,6,33.3,4,10,2,8,4,14,5,0
ITA-Serie A,2425,Lazio,Gaetano Castrovilli,,,27.0,1997.0,1.6,5,2,3,1,1,2,4,50.0,2,3,0,3,3,8,1,0
ITA-Serie A,2425,Lazio,Gustav Isaksen,,,23.0,2001.0,24.6,16,9,7,8,1,7,28,25.0,21,22,2,20,10,26,21,1
ITA-Serie A,2425,Lazio,Ivan Provedel,,,30.0,1994.0,29.0,0,0,0,0,0,0,0,,0,1,0,1,1,1,12,3
ITA-Serie A,2425,Lazio,Loum Tchaouna,,,20.0,2003.0,7.3,8,4,2,2,4,3,9,33.3,6,5,1,4,4,12,14,2
ITA-Serie A,2425,Lazio,Luca Pellegrini,,,25.0,1999.0,11.9,23,11,11,10,2,17,32,53.1,15,10,3,7,19,42,32,0
ITA-Serie A,2425,Lazio,Manuel Lazzari,,,30.0,1993.0,15.6,26,16,13,11,2,14,24,58.3,10,9,5,4,10,36,19,0
ITA-Serie A,2425,Lazio,Mario Gila,,,23.0,2000.0,30.5,55,37,35,18,2,37,56,66.1,19,20,13,7,28,83,115,4
ITA-Serie A,2425,Lazio,Mattia Zaccagni,,,29.0,1995.0,29.8,38,27,13,21,4,16,32,50.0,16,19,1,18,29,67,22,2
ITA-Serie A,2425,Lazio,Mattéo Guendouzi,,,25.0,1999.0,36.3,37,21,13,19,5,20,47,42.6,27,34,9,25,32,69,50,2
ITA-Serie A,2425,Lazio,Matías Vecino,,,32.0,1991.0,9.7,13,7,3,9,1,4,18,22.2,14,9,3,6,5,18,15,0
ITA-Serie A,2425,Lazio,Nicolò Casale,,,26.0,1998.0,1.5,5,3,4,1,0,0,0,,0,4,3,1,1,6,2,0
ITA-Serie A,2425,Lazio,Nicolò Rovella,,,22.0,2001.0,30.2,84,50,39,38,7,41,79,51.9,38,19,4,15,47,131,46,3
ITA-Serie A,2425,Lazio,Nuno Tavares,,,24.0,2000.0,18.7,28,21,15,8,5,14,34,41.2,20,21,3,18,21,49,44,2
ITA-Serie A,2425,Lazio,Oliver Nielsen,,,21.0,2003.0,0.4,0,0,0,0,0,0,0,,0,1,0,1,1,1,2,0
ITA-Serie A,2425,Lazio,Patric,,,31.0,1993.0,6.7,9,6,6,3,0,6,10,60.0,4,3,2,1,3,12,22,1
ITA-Serie A,2425,Lazio,Pedro,,,37.0,1987.0,12.2,19,14,5,9,5,10,21,47.6,11,11,0,11,3,22,3,1
ITA-Serie A,2425,Lazio,Reda Belahyane,,,20.0,2004.0,2.2,8,6,8,0,0,6,6,100.0,0,3,2,1,1,9,5,0
ITA-Serie A,2425,Lazio,Samuel Gigot,,,30.0,1993.0,7.6,4,3,1,3,0,0,1,0.0,1,8,6,2,13,17,36,0
ITA-Serie A,2425,Lazio,Tijjani Noslin,,,25.0,1999.0,9.6,6,5,2,1,3,1,8,12.5,7,15,1,14,1,7,7,0
ITA-Serie A,2425,Lazio,Valentín Castellanos,,,25.0,1998.0,26.5,13,6,2,4,7,1,10,10.0,9,18,2,16,6,19,25,0
ITA-Serie A,2425,Lecce,Andy Pelmard,,,24.0,2000.0,1.4,6,6,5,1,0,4,4,100.0,0,1,0,1,0,6,5,0
ITA-Serie A,2425,Lecce,Ante Rebić,,,30.0,1993.0,8.8,12,9,5,5,2,3,9,33.3,6,7,1,6,2,14,4,1
ITA-Serie A,2425,Lecce,Antonino Gallo,,,24.0,2000.0,29.0,65,42,46,15,4,34,62,54.8,28,33,6,27,20,85,133,0
ITA-Serie A,2425,Lecce,Balthazar Pierret,,,24.0,2000.0,19.1,51,31,25,23,3,13,30,43.3,17,19,5,14,19,70,31,1
ITA-Serie A,2425,Lecce,Danilo Veiga,,,21.0,2002.0,4.2,8,6,4,4,0,6,13,46.2,7,5,0,5,4,12,14,0
ITA-Serie A,2425,Lecce,Federico Baschirotto,,,27.0,1996.0,38.0,37,25,30,5,2,22,28,78.6,6,44,32,12,23,60,237,2
ITA-Serie A,2425,Lecce,Filip Marchwiński,,,22.0,2002.0,0.2,0,0,0,0,0,0,0,,0,0,0,0,0,0,0,0
ITA-Serie A,2425,Lecce,Frederic Guilbert,,,29.0,1994.0,27.1,65,36,30,29,6,36,55,65.5,19,28,8,20,47,112,113,3
ITA-Serie A,2425,Lecce,Gaby Jean,,,24.0,2000.0,15.4,14,7,8,5,1,6,11,54.5,5,13,10,3,9,23,71,1
ITA-Serie A,2425,Lecce,Hamza Rafia,,,25.0,1999.0,11.8,44,27,14,25,5,15,32,46.9,17,7,2,5,4,48,18,1
ITA-Serie A,2425,Lecce,Jesper Karlsson,,,26.0,1998.0,5.5,3,2,3,0,0,2,8,25.0,6,2,0,2,0,3,4,0
ITA-Serie A,2425,Lecce,Kevin Bonifazi,,,28.0,1996.0,0.7,1,1,1,0,0,1,1,100.0,0,1,1,0,2,3,3,0
ITA-Serie A,2425,Lecce,Kialonda,,,26.0,1997.0,23.8,34,12,24,10,0,12,17,70.6,5,44,28,16,32,66,132,1
ITA-Serie A,2425,Lecce,Konan N'dri,,,23.0,2000.0,3.4,3,3,0,0,3,2,3,66.7,1,4,0,4,1,4,0,0
ITA-Serie A,2425,Lecce,Lameck Banda,,,23.0,2001.0,6.8,8,5,4,2,2,3,12,25.0,9,7,0,7,2,10,8,1
ITA-Serie A,2425,Lecce,Lassana Coulibaly,,,28.0,1996.0,29.6,48,29,16,28,4,24,61,39.3,37,45,12,33,18,66,46,1
ITA-Serie A,2425,Lecce,Marco Sala,,,25.0,1999.0,0.8,1,0,0,1,0,0,1,0.0,1,1,0,1,0,1,0,0
ITA-Serie A,2425,Lecce,Medon Berisha,,,20.0,2003.0,8.0,12,8,7,3,2,4,8,50.0,4,6,0,6,11,23,5,2
ITA-Serie A,2425,Lecce,Mohamed Kaba,,,22.0,2001.0,5.0,13,8,7,5,1,8,10,80.0,2,11,4,7,4,17,10,1
ITA-Serie A,2425,Lecce,Nicola Sansone,,,32.0,1991.0,0.7,0,0,0,0,0,0,0,,0,0,0,0,0,0,0,0
ITA-Serie A,2425,Lecce,Nikola Krstović,,,24.0,2000.0,34.0,18,9,4,7,7,7,16,43.8,9,12,7,5,7,25,24,0
ITA-Serie A,2425,Lecce,Patrick Dorgu,,,19.0,2004.0,20.4,45,27,21,19,5,23,45,51.1,22,24,6,18,18,63,42,2
ITA-Serie A,2425,Lecce,Rareș-Cătălin Burnete,,,20.0,2004.0,0.3,0,0,0,0,0,0,1,0.0,1,0,0,0,0,0,0,0
ITA-Serie A,2425,Lecce,Remi Oudin,,,27.0,1996.0,3.3,3,1,1,1,1,2,4,50.0,2,6,2,4,2,5,1,0
ITA-Serie A,2425,Lecce,Santiago Pierotti,,,23.0,2001.0,21.5,46,24,22,18,6,23,51,45.1,28,31,5,26,14,60,32,0
ITA-Serie A,2425,Lecce,Tete Morente,,,27.0,1996.0,22.5,27,17,10,11,6,10,36,27.8,26,16,1,15,14,41,31,1
ITA-Serie A,2425,Lecce,Tiago Gabriel,,,19.0,2004.0,1.1,0,0,0,0,0,0,0,,0,4,2,2,0,0,11,0
ITA-Serie A,2425,Lecce,Valentin Gendrey,,,24.0,2000.0,2.0,2,2,1,0,1,1,1,100.0,0,3,1,2,2,4,1,0
ITA-Serie A,2425,Lecce,Wladimiro Falcone,,,29.0,1995.0,38.0,0,0,0,0,0,0,0,,0,0,0,0,0,0,29,3
ITA-Serie A,2425,Lecce,Ylber Ramadani,,,28.0,1996.0,20.1,51,28,24,27,0,33,52,63.5,19,26,9,17,24,75,26,3
ITA-Serie A,2425,Lecce,Þórir Jóhann Helgason,,,23.0,2000.0,12.8,10,7,3,6,1,7,13,53.8,6,7,2,5,6,16,11,2
ITA-Serie A,2425,Milan,Alejandro Jiménez,,,19.0,2005.0,14.1,24,13,8,14,2,11,27,40.7,16,24,3,21,15,39,23,0
ITA-Serie A,2425,Milan,Alessandro Florenzi,,,33.0,1991.0,0.1,0,0,0,0,0,0,0,,0,0,0,0,0,0,0,0
ITA-Serie A,2425,Milan,Alexis Saelemaekers,,,25.0,1999.0,1.0,1,1,0,0,1,1,1,100.0,0,0,0,0,1,2,0,0
ITA-Serie A,2425,Milan,Bob Murphy Omoregbe,,,20.0,2003.0,0.0,0,0,0,0,0,0,0,,0,0,0,0,0,0,0,0
ITA-Serie A,2425,Milan,Christian Pulisic,,,25.0,1998.0,27.5,43,29,17,14,12,15,37,40.5,22,24,2,22,5,48,13,2
ITA-Serie A,2425,Milan,Davide Bartesaghi,,,18.0,2005.0,1.3,4,2,1,1,2,4,4,100.0,0,1,1,0,3,7,1,0
ITA-Serie A,2425,Milan,Davide Calabria,,,27.0,1996.0,3.5,10,7,10,0,0,4,7,57.1,3,1,0,1,8,18,8,0
ITA-Serie A,2425,Milan,Emerson,,,25.0,1999.0,15.3,45,28,24,16,5,16,34,47.1,18,13,2,11,14,59,56,0
ITA-Serie A,2425,Milan,Fikayo Tomori,,,26.0,1997.0,17.7,40,25,21,16,3,17,25,68.0,8,17,12,5,20,60,61,2
ITA-Serie A,2425,Milan,Filippo Terracciano,,,21.0,2003.0,6.0,9,6,1,6,2,5,10,50.0,5,1,0,1,6,15,11,0
ITA-Serie A,2425,Milan,Francesco Camarda,,,16.0,2008.0,2.3,5,2,0,2,3,2,6,33.3,4,2,1,1,0,5,3,0
ITA-Serie A,2425,Milan,Ismaël Bennacer,,,26.0,1997.0,3.3,5,4,1,3,1,1,7,14.3,6,5,3,2,3,8,1,0
ITA-Serie A,2425,Milan,João Félix,,,24.0,1999.0,8.4,6,6,3,2,1,4,14,28.6,10,2,0,2,1,7,9,0
ITA-Serie A,2425,Milan,Kevin Zeroli,,,19.0,2005.0,0.1,1,1,0,1,0,0,0,,0,0,0,0,0,1,0,0
ITA-Serie A,2425,Milan,Kyle Walker,,,34.0,1990.0,7.3,17,9,12,4,1,13,17,76.5,4,9,5,4,9,26,15,1
ITA-Serie A,2425,Milan,Luka Jović,,,26.0,1997.0,6.2,0,0,0,0,0,0,0,,0,2,1,1,1,1,3,0
ITA-Serie A,2425,Milan,Malick Thiaw,,,22.0,2001.0,20.1,24,17,15,6,3,6,10,60.0,4,14,12,2,15,39,76,1
ITA-Serie A,2425,Milan,Marco Sportiello,,,32.0,1992.0,1.4,0,0,0,0,0,0,0,,0,0,0,0,0,0,1,0
ITA-Serie A,2425,Milan,Matteo Gabbia,,,24.0,1999.0,23.9,21,15,13,7,1,8,10,80.0,2,25,19,6,15,36,103,1
ITA-Serie A,2425,Milan,Mattia Liberali,,,17.0,2007.0,0.7,2,1,0,1,1,2,2,100.0,0,0,0,0,0,2,0,0
ITA-Serie A,2425,Milan,Mike Maignan,,,29.0,1995.0,36.6,0,0,0,0,0,0,1,0.0,1,1,0,1,0,0,19,3
ITA-Serie A,2425,Milan,Noah Okafor,,,24.0,2000.0,4.6,2,1,0,0,2,0,1,0.0,1,1,0,1,2,4,1,0
ITA-Serie A,2425,Milan,Rafael Leão,,,25.0,1999.0,25.8,16,10,4,8,4,11,29,37.9,18,15,1,14,6,22,4,0
ITA-Serie A,2425,Milan,Riccardo Sottil,,,25.0,1999.0,1.4,1,1,1,0,0,0,0,,0,0,0,0,0,1,0,0
ITA-Serie A,2425,Milan,Ruben Loftus-Cheek,,,28.0,1996.0,11.5,19,8,6,9,4,6,12,50.0,6,3,0,3,3,22,20,0
ITA-Serie A,2425,Milan,Samuel Chukwueze,,,25.0,1999.0,10.3,17,11,7,6,4,5,19,26.3,14,3,0,3,2,19,9,0
ITA-Serie A,2425,Milan,Santiago Giménez,,,23.0,2001.0,7.4,5,3,0,4,1,3,4,75.0,1,3,1,2,1,6,13,0
ITA-Serie A,2425,Milan,Strahinja Pavlović,,,23.0,2001.0,20.7,52,31,32,19,1,29,50,58.0,21,17,6,11,16,68,82,0
ITA-Serie A,2425,Milan,Tammy Abraham,,,26.0,1997.0,13.1,17,11,2,10,5,6,8,75.0,2,13,0,13,2,19,16,0
ITA-Serie A,2425,Milan,Theo Hernández,,,26.0,1997.0,30.0,36,28,23,10,3,21,39,53.8,18,25,10,15,17,53,75,3
ITA-Serie A,2425,Milan,Tijjani Reijnders,,,26.0,1998.0,34.8,26,13,6,14,6,10,26,38.5,16,22,4,18,38,64,28,2
ITA-Serie A,2425,Milan,Warren Bondo,,,20.0,2003.0,1.8,5,3,4,1,0,3,3,100.0,0,1,0,1,0,5,2,0
ITA-Serie A,2425,Milan,Youssouf Fofana,,,25.0,1999.0,27.8,56,34,20,31,5,26,52,50.0,26,32,9,23,19,75,24,3
ITA-Serie A,2425,Milan,Yunus Musah,,,21.0,2002.0,17.5,27,19,13,9,5,12,17,70.6,5,9,1,8,7,34,9,3
ITA-Serie A,2425,Milan,Álvaro Morata,,,31.0,1992.0,12.2,16,10,5,8,3,5,8,62.5,3,7,2,5,5,21,5,0
ITA-Serie A,2425,Monza,Alessandro Bianco,,,21.0,2002.0,28.9,51,28,26,17,8,27,41,65.9,14,40,14,26,22,73,53,4
ITA-Serie A,2425,Monza,Andrea Carboni,,,23.0,2001.0,24.3,60,35,39,17,4,35,53,66.0,18,31,16,15,27,87,106,4
ITA-Serie A,2425,Monza,Andrea Mazza,,,20.0,2004.0,0.1,0,0,0,0,0,0,0,,0,0,0,0,0,0,0,0
ITA-Serie A,2425,Monza,Andrea Petagna,,,29.0,1995.0,3.7,2,1,0,1,1,1,2,50.0,1,0,0,0,1,3,2,0
ITA-Serie A,2425,Monza,Armando Izzo,,,32.0,1992.0,27.1,40,15,30,9,1,18,36,50.0,18,38,28,10,45,85,101,0
ITA-Serie A,2425,Monza,Arvid Brorsson,,,25.0,1999.0,4.0,4,3,2,2,0,2,5,40.0,3,9,8,1,2,6,35,1
ITA-Serie A,2425,Monza,Daniel Maldini,,,22.0,2001.0,14.5,14,6,5,9,0,6,13,46.2,7,8,2,6,4,18,12,2
ITA-Serie A,2425,Monza,Danilo D'Ambrosio,,,35.0,1988.0,12.2,28,15,17,10,1,14,23,60.9,9,12,8,4,15,43,36,2
ITA-Serie A,2425,Monza,Dany Mota,,,26.0,1998.0,23.4,13,3,2,3,8,4,8,50.0,4,18,1,17,9,22,27,3
ITA-Serie A,2425,Monza,Gaetano Castrovilli,,,27.0,1997.0,6.6,12,7,10,2,0,4,11,36.4,7,8,2,6,2,14,9,0
ITA-Serie A,2425,Monza,Gianluca Caprari,,,31.0,1993.0,18.3,19,11,8,8,3,7,14,50.0,7,14,0,14,8,27,2,1
ITA-Serie A,2425,Monza,Giorgos Kyriakopoulos,,,28.0,1996.0,31.6,43,26,20,18,5,30,61,49.2,31,28,10,18,23,66,79,0
ITA-Serie A,2425,Monza,Jean-Daniel Akpa-Akpro,,,31.0,1992.0,10.7,30,18,15,14,1,9,21,42.9,12,19,6,13,13,43,16,1
ITA-Serie A,2425,Monza,Kacper Urbanski,,,19.0,2004.0,5.6,5,3,1,2,2,4,7,57.1,3,7,2,5,2,7,9,0
ITA-Serie A,2425,Monza,Keita Baldé,,,29.0,1995.0,7.1,1,1,0,1,0,1,2,50.0,1,4,0,4,2,3,0,0
ITA-Serie A,2425,Monza,Kevin Martins,,,19.0,2005.0,2.0,5,4,3,2,0,3,6,50.0,3,1,0,1,1,6,4,1
ITA-Serie A,2425,Monza,Kevin Zeroli,,,19.0,2005.0,4.4,6,2,3,3,0,0,1,0.0,1,6,1,5,2,8,11,0
ITA-Serie A,2425,Monza,Luca Caldirola,,,33.0,1991.0,9.7,11,7,8,3,0,4,7,57.1,3,9,6,3,11,22,43,1
ITA-Serie A,2425,Monza,Matteo Pessina,,,27.0,1997.0,9.5,15,4,3,11,1,9,14,64.3,5,6,0,6,12,27,7,0
ITA-Serie A,2425,Monza,Mattia Valoti,,,30.0,1993.0,0.4,3,3,3,0,0,0,2,0.0,2,2,0,2,0,3,2,0
ITA-Serie A,2425,Monza,Milan Đurić,,,34.0,1990.0,14.1,1,1,0,1,0,0,3,0.0,3,6,0,6,2,3,17,0
ITA-Serie A,2425,Monza,Mirko Marić,,,29.0,1995.0,1.2,1,0,1,0,0,1,2,50.0,1,1,1,0,1,2,1,0
ITA-Serie A,2425,Monza,Omari Forson,,,20.0,2004.0,2.5,3,3,1,2,0,1,3,33.3,2,3,0,3,1,4,1,0
ITA-Serie A,2425,Monza,Pablo Marí,,,30.0,1993.0,18.1,26,15,14,12,0,11,21,52.4,10,24,21,3,37,63,85,2
ITA-Serie A,2425,Monza,Patrick Ciurria,,,29.0,1995.0,12.3,22,14,11,7,4,4,11,36.4,7,13,3,10,6,28,22,0
ITA-Serie A,2425,Monza,Pedro Pereira,,,26.0,1998.0,29.6,53,32,30,18,5,35,55,63.6,20,26,12,14,21,74,85,5
ITA-Serie A,2425,Monza,Roberto Gagliardini,,,30.0,1994.0,2.0,3,2,1,2,0,1,4,25.0,3,1,0,1,2,5,4,0
ITA-Serie A,2425,Monza,Samuele Birindelli,,,25.0,1999.0,16.3,22,15,13,4,5,6,14,42.9,8,15,2,13,10,32,34,2
ITA-Serie A,2425,Monza,Samuele Vignato,,,20.0,2004.0,5.2,6,3,0,4,2,3,7,42.9,4,1,0,1,0,6,6,0
ITA-Serie A,2425,Monza,Semuel Pizzignacco,,,22.0,2001.0,8.2,0,0,0,0,0,0,1,0.0,1,0,0,0,0,0,6,0
ITA-Serie A,2425,Monza,Silvère Ganvoula M'Boussy,,,28.0,1996.0,3.6,0,0,0,0,0,0,1,0.0,1,1,0,1,1,1,5,0
ITA-Serie A,2425,Monza,Stefan Lekovic,,,20.0,2004.0,4.1,9,4,6,2,1,5,13,38.5,8,4,4,0,7,16,5,0
ITA-Serie A,2425,Monza,Stefano Sensi,,,28.0,1995.0,3.0,8,5,4,4,0,5,6,83.3,1,4,2,2,3,11,3,1
ITA-Serie A,2425,Monza,Stefano Turati,,,22.0,2001.0,29.7,0,0,0,0,0,0,1,0.0,1,0,0,0,0,0,21,2
ITA-Serie A,2425,Monza,Tomás Palacios,,,21.0,2003.0,5.0,11,5,9,2,0,9,13,69.2,4,7,2,5,8,19,17,2
ITA-Serie A,2425,Monza,Warren Bondo,,,20.0,2003.0,18.0,35,24,19,12,4,13,19,68.4,6,16,6,10,5,40,8,4
ITA-Serie A,2425,Napoli,Alessandro Buongiorno,,,25.0,1999.0,21.4,39,23,26,12,1,24,32,75.0,8,30,18,12,35,74,73,2
ITA-Serie A,2425,Napoli,Alessio Zerbin,,,25.0,1999.0,0.0,2,1,2,0,0,1,1,100.0,0,0,0,0,0,2,0,0
ITA-Serie A,2425,Napoli,Alex Meret,,,27.0,1997.0,33.4,0,0,0,0,0,0,0,,0,1,0,1,0,0,16,0
ITA-Serie A,2425,Napoli,Amir Rrahmani,,,30.0,1994.0,37.8,39,31,19,19,1,16,25,64.0,9,43,26,17,27,66,179,2
ITA-Serie A,2425,Napoli,Andre-Frank Zambo Anguissa,,,28.0,1995.0,31.7,42,26,8,28,6,15,34,44.1,19,24,6,18,35,77,40,1
ITA-Serie A,2425,Napoli,Billy Gilmour,,,23.0,2001.0,13.1,24,16,10,9,5,12,20,60.0,8,6,1,5,9,33,23,0
ITA-Serie A,2425,Napoli,Cyril Ngonge,,,24.0,2000.0,2.4,8,5,4,4,0,4,7,57.1,3,3,0,3,2,10,4,0
ITA-Serie A,2425,Napoli,David Neres,,,27.0,1997.0,14.3,21,11,10,4,7,10,15,66.7,5,7,0,7,7,28,4,0
ITA-Serie A,2425,Napoli,Elia Caprile,,,22.0,2001.0,3.6,0,0,0,0,0,0,0,,0,0,0,0,0,0,2,0
ITA-Serie A,2425,Napoli,Giacomo Raspadori,,,24.0,2000.0,12.3,18,9,6,10,2,8,12,66.7,4,10,2,8,3,21,13,0
ITA-Serie A,2425,Napoli,Giovanni Di Lorenzo,,,30.0,1993.0,37.0,66,44,35,25,6,42,65,64.6,23,19,6,13,31,97,85,1
ITA-Serie A,2425,Napoli,Giovanni Simeone,,,29.0,1995.0,4.7,2,0,0,1,1,1,6,16.7,5,9,2,7,1,3,6,0
ITA-Serie A,2425,Napoli,Juan Jesus,,,33.0,1991.0,11.9,25,14,16,9,0,12,20,60.0,8,15,3,12,9,34,42,0
ITA-Serie A,2425,Napoli,Khvicha Kvaratskhelia,,,23.0,2001.0,13.1,15,9,4,10,1,4,15,26.7,11,13,0,13,4,19,7,0
ITA-Serie A,2425,Napoli,Leonardo Spinazzola,,,31.0,1993.0,16.9,17,10,6,9,2,10,23,43.5,13,12,1,11,9,26,31,1
ITA-Serie A,2425,Napoli,Mathías Olivera,,,26.0,1997.0,26.3,63,35,31,25,7,32,53,60.4,21,36,12,24,28,91,74,1
ITA-Serie A,2425,Napoli,Matteo Politano,,,30.0,1993.0,31.2,29,15,17,11,1,15,43,34.9,28,21,1,20,13,42,50,1
ITA-Serie A,2425,Napoli,Michael Folorunsho,,,26.0,1998.0,0.4,3,2,0,3,0,2,4,50.0,2,0,0,0,1,4,1,1
ITA-Serie A,2425,Napoli,Noah Okafor,,,24.0,2000.0,0.4,3,2,3,0,0,2,2,100.0,0,0,0,0,0,3,1,0
ITA-Serie A,2425,Napoli,Pasquale Mazzocchi,,,29.0,1995.0,7.8,15,7,7,5,3,8,15,53.3,7,5,2,3,5,20,25,0
ITA-Serie A,2425,Napoli,Philip Billing,,,28.0,1996.0,2.2,9,6,4,4,1,1,4,25.0,3,4,1,3,4,13,6,0
ITA-Serie A,2425,Napoli,Rafa Marín,,,22.0,2002.0,1.6,1,0,1,0,0,1,2,50.0,1,1,1,0,1,2,4,0
ITA-Serie A,2425,Napoli,Romelu Lukaku,,,31.0,1993.0,31.6,4,2,0,2,2,1,4,25.0,3,7,2,5,1,5,17,0
ITA-Serie A,2425,Napoli,Scott McTominay,,,27.0,1996.0,32.6,43,25,12,27,4,18,36,50.0,18,22,5,17,24,67,51,0
ITA-Serie A,2425,Napoli,Simone Scuffet,,,28.0,1996.0,1.0,0,0,0,0,0,0,0,,0,0,0,0,0,0,2,0
ITA-Serie A,2425,Napoli,Stanislav Lobotka,,,29.0,1994.0,29.3,47,30,16,21,10,19,31,61.3,12,29,11,18,21,68,57,1
ITA-Serie A,2425,Napoli,Walid Cheddira,,,26.0,1998.0,0.1,0,0,0,0,0,0,0,,0,0,0,0,0,0,0,0
ITA-Serie A,2425,Parma,Adrian Benedyczak,,,23.0,2000.0,2.4,0,0,0,0,0,0,1,0.0,1,3,1,2,0,0,8,0
ITA-Serie A,2425,Parma,Adrian Bernabe,,,23.0,2001.0,16.1,29,18,16,9,4,14,32,43.8,18,22,9,13,7,36,26,1
ITA-Serie A,2425,Parma,Alessandro Circati,,,20.0,2003.0,6.0,7,5,6,1,0,1,2,50.0,1,5,4,1,3,10,42,1
ITA-Serie A,2425,Parma,Alessandro Vogliacco,,,25.0,1998.0,8.6,5,2,5,0,0,3,5,60.0,2,15,10,5,3,8,37,0
ITA-Serie A,2425,Parma,Ange-Yoan Bonny,,,20.0,2003.0,28.1,34,16,4,23,7,8,14,57.1,6,17,2,15,3,37,17,0
ITA-Serie A,2425,Parma,Antoine Hainaut,,,22.0,2002.0,13.4,26,14,15,8,3,9,13,69.2,4,17,4,13,15,41,59,1
ITA-Serie A,2425,Parma,Botond Balogh,,,22.0,2002.0,22.8,36,16,22,13,1,20,28,71.4,8,34,26,8,25,61,141,2
ITA-Serie A,2425,Parma,Dennis Man,,,25.0,1998.0,22.2,13,6,7,3,3,6,24,25.0,18,15,3,12,8,21,11,0
ITA-Serie A,2425,Parma,Drissa Camara,,,22.0,2002.0,5.0,9,7,2,6,1,1,10,10.0,9,8,0,8,3,12,1,0
ITA-Serie A,2425,Parma,Emanuele Valeri,,,25.0,1998.0,31.9,51,31,33,15,3,30,61,49.2,31,31,10,21,29,80,103,4
ITA-Serie A,2425,Parma,Enrico Del Prato,,,24.0,1999.0,32.7,33,17,24,8,1,19,26,73.1,7,69,35,34,19,52,132,2
ITA-Serie A,2425,Parma,Gabriel Charpentier,,,25.0,1999.0,3.0,4,3,2,1,1,3,4,75.0,1,3,0,3,0,4,9,0
ITA-Serie A,2425,Parma,Giovanni Leoni,,,17.0,2006.0,13.3,14,6,10,4,0,5,10,50.0,5,20,11,9,15,29,63,1
ITA-Serie A,2425,Parma,Hernani,,,30.0,1994.0,14.7,47,26,25,18,4,27,50,54.0,23,26,6,20,19,66,12,1
ITA-Serie A,2425,Parma,Jacob Ondrejka,,,21.0,2002.0,4.7,12,6,5,7,0,10,12,83.3,2,2,0,2,7,19,2,0
ITA-Serie A,2425,Parma,Lautaro Valenti,,,25.0,1999.0,17.3,17,12,13,3,1,7,9,77.8,2,26,13,13,13,30,94,1
ITA-Serie A,2425,Parma,Leandro Chichizola,,,34.0,1990.0,1.0,0,0,0,0,0,0,0,,0,0,0,0,0,0,2,0
ITA-Serie A,2425,Parma,Mandela Keita,,,22.0,2002.0,20.3,44,25,13,25,6,18,35,51.4,17,18,7,11,21,65,29,2
ITA-Serie A,2425,Parma,Mateo Pellegrino,,,23.0,2001.0,8.2,3,2,1,2,0,1,4,25.0,3,6,1,5,1,4,6,0
ITA-Serie A,2425,Parma,Mateusz Kowalski,,,19.0,2005.0,0.6,0,0,0,0,0,0,0,,0,1,0,1,0,0,1,0
ITA-Serie A,2425,Parma,Mathias Løvik,,,20.0,2003.0,1.0,1,0,0,1,0,1,3,33.3,2,1,1,0,2,3,3,0
ITA-Serie A,2425,Parma,Matteo Cancellieri,,,22.0,2002.0,15.8,26,16,15,9,2,11,32,34.4,21,15,1,14,13,39,30,0
ITA-Serie A,2425,Parma,Milan Đurić,,,34.0,1990.0,3.0,0,0,0,0,0,0,2,0.0,2,3,0,3,0,0,2,0
ITA-Serie A,2425,Parma,Mohamed Haj,,,19.0,2005.0,5.0,3,1,2,1,0,1,2,50.0,1,3,1,2,4,7,5,0
ITA-Serie A,2425,Parma,Nahuel Estévez,,,28.0,1995.0,7.3,16,6,7,8,1,6,15,40.0,9,9,2,7,3,19,26,0
ITA-Serie A,2425,Parma,Pontus Almqvist,,,25.0,1999.0,12.4,17,13,7,7,3,8,17,47.1,9,13,0,13,19,36,8,0
ITA-Serie A,2425,Parma,Simon Sohm,,,23.0,2001.0,33.2,28,17,11,13,4,16,35,45.7,19,11,3,8,26,54,36,0
ITA-Serie A,2425,Parma,Valentin Mihaila,,,24.0,2000.0,14.3,29,15,8,13,8,9,22,40.9,13,18,0,18,8,37,6,0
ITA-Serie A,2425,Parma,Woyo Coulibaly,,,25.0,1999.0,12.0,13,10,9,2,2,5,11,45.5,6,19,2,17,8,21,25,0
ITA-Serie A,2425,Parma,Wylan Cyprien,,,29.0,1995.0,0.3,0,0,0,0,0,0,1,0.0,1,1,0,1,1,1,0,0
ITA-Serie A,2425,Parma,Yordan Osorio,,,30.0,1994.0,1.9,5,3,4,1,0,2,2,100.0,0,3,1,2,4,9,6,1
ITA-Serie A,2425,Parma,Zion Suzuki,,,21.0,2002.0,36.8,1,0,1,0,0,1,2,50.0,1,0,0,0,0,1,35,4
ITA-Serie A,2425,Roma,Alexis Saelemaekers,,,25.0,1999.0,15.4,33,20,22,7,4,18,35,51.4,17,12,1,11,9,42,8,1
ITA-Serie A,2425,Roma,Anass Salah-Eddine,,,22.0,2002.0,1.7,1,1,1,0,0,0,0,,0,0,0,0,1,2,2,2
ITA-Serie A,2425,Roma,Angeliño,,,27.0,1997.0,35.3,46,24,20,24,2,17,34,50.0,17,33,9,24,28,74,98,0
ITA-Serie A,2425,Roma,Artem Dovbyk,,,27.0,1997.0,26.9,4,2,0,1,3,0,4,0.0,4,10,3,7,2,6,12,0
ITA-Serie A,2425,Roma,Bryan Cristante,,,29.0,1995.0,22.7,48,29,18,24,6,15,26,57.7,11,20,10,10,19,67,36,1
ITA-Serie A,2425,Roma,Devyne Rensch,,,21.0,2003.0,5.2,17,13,8,8,1,9,10,90.0,1,5,3,2,7,24,12,1
ITA-Serie A,2425,Roma,Eldor Shomurodov,,,29.0,1995.0,12.2,14,6,2,7,5,3,6,50.0,3,10,1,9,3,17,5,0
ITA-Serie A,2425,Roma,Enzo Le Fée,,,24.0,2000.0,3.5,7,4,5,2,0,2,6,33.3,4,9,3,6,5,12,2,0
ITA-Serie A,2425,Roma,Gianluca Mancini,,,28.0,1996.0,34.9,42,26,22,18,2,20,34,58.8,14,22,16,6,35,77,103,0
ITA-Serie A,2425,Roma,Leandro Paredes,,,30.0,1994.0,15.3,26,14,9,12,5,16,32,50.0,16,14,5,9,19,45,33,2
ITA-Serie A,2425,Roma,Lorenzo Pellegrini,,,28.0,1996.0,18.1,24,16,5,13,6,8,19,42.1,11,8,1,7,6,30,22,0
ITA-Serie A,2425,Roma,Lucas Gourna-Douath,,,20.0,2003.0,2.5,9,4,5,4,0,2,6,33.3,4,1,1,0,0,9,2,0
ITA-Serie A,2425,Roma,Manu Koné,,,23.0,2001.0,28.6,41,26,17,17,7,19,40,47.5,21,27,4,23,24,65,28,0
ITA-Serie A,2425,Roma,Mario Hermoso,,,29.0,1995.0,2.8,2,1,2,0,0,0,1,0.0,1,1,1,0,4,6,13,0
ITA-Serie A,2425,Roma,Mats Hummels,,,35.0,1988.0,10.2,30,15,16,14,0,11,18,61.1,7,12,4,8,26,56,43,0
ITA-Serie A,2425,Roma,Matìas Soulé,,,21.0,2003.0,19.8,26,16,12,7,7,10,23,43.5,13,25,3,22,9,35,25,0
ITA-Serie A,2425,Roma,Mile Svilar,,,24.0,1999.0,38.0,0,0,0,0,0,0,0,,0,0,0,0,0,0,12,2
ITA-Serie A,2425,Roma,Niccolò Pisilli,,,19.0,2004.0,13.6,24,11,11,8,5,12,22,54.5,10,14,3,11,11,35,16,0
ITA-Serie A,2425,Roma,Nicola Zalewski,,,22.0,2002.0,5.9,8,6,3,2,3,2,7,28.6,5,7,2,5,4,12,8,2
ITA-Serie A,2425,Roma,Obite N'Dicka,,,24.0,1999.0,38.0,32,26,17,15,0,14,21,66.7,7,46,30,16,33,65,150,2
ITA-Serie A,2425,Roma,Paulo Dybala,,,30.0,1993.0,15.7,17,7,3,9,5,8,19,42.1,11,12,1,11,2,19,2,0
ITA-Serie A,2425,Roma,Samuel Dahl,,,24.0,2000.0,0.5,2,2,0,2,0,1,2,50.0,1,2,0,2,0,2,0,0
ITA-Serie A,2425,Roma,Saud Abdulhamid,,,25.0,1999.0,2.3,3,2,2,0,1,1,1,100.0,0,2,0,2,2,5,0,0
ITA-Serie A,2425,Roma,Stephan El Shaarawy,,,31.0,1992.0,12.2,16,12,4,6,6,6,12,50.0,6,4,0,4,10,26,13,0
ITA-Serie A,2425,Roma,Tammy Abraham,,,26.0,1997.0,0.0,0,0,0,0,0,0,1,0.0,1,0,0,0,0,0,0,0
ITA-Serie A,2425,Roma,Tommaso Baldanzi,,,21.0,2003.0,9.2,12,4,5,4,3,4,12,33.3,8,4,0,4,6,18,8,0
ITA-Serie A,2425,Roma,Victor Nelsson,,,25.0,1998.0,2.1,5,4,3,1,1,3,5,60.0,2,1,0,1,2,7,9,0
ITA-Serie A,2425,Roma,Zeki Çelik,,,27.0,1997.0,25.1,62,37,21,31,10,23,43,53.5,20,28,9,19,15,77,84,3
ITA-Serie A,2425,Torino,Aaron Ciammaglichella,,,19.0,2005.0,0.0,0,0,0,0,0,0,0,,0,0,0,0,0,0,0,0
ITA-Serie A,2425,Torino,Adam Masina,,,30.0,1994.0,21.3,33,15,22,10,1,23,40,57.5,17,28,15,13,27,60,95,2
ITA-Serie A,2425,Torino,Adrien Tameze,,,30.0,1994.0,7.2,5,2,2,3,0,1,10,10.0,9,8,5,3,10,15,8,1
ITA-Serie A,2425,Torino,Alberto Paleari,,,31.0,1992.0,1.0,0,0,0,0,0,0,0,,0,0,0,0,0,0,2,0
ITA-Serie A,2425,Torino,Alessio Cacciamani,,,17.0,2007.0,0.3,0,0,0,0,0,0,0,,0,0,0,0,1,1,0,0
ITA-Serie A,2425,Torino,Ali Dembélé,,,20.0,2004.0,4.3,9,5,6,3,0,4,4,100.0,0,6,2,4,1,10,11,1
ITA-Serie A,2425,Torino,Antonio Sanabria,,,28.0,1996.0,14.6,3,3,1,1,1,1,4,25.0,3,6,1,5,1,4,13,0
ITA-Serie A,2425,Torino,Borna Sosa,,,26.0,1998.0,13.1,26,19,14,7,5,16,25,64.0,9,13,6,7,14,40,33,0
ITA-Serie A,2425,Torino,Cesare Casadei,,,21.0,2003.0,11.3,12,5,4,8,0,5,10,50.0,5,4,2,2,5,17,26,0
ITA-Serie A,2425,Torino,Che Adams,,,28.0,1996.0,29.5,12,6,2,4,6,1,7,14.3,6,13,6,7,2,14,18,0
ITA-Serie A,2425,Torino,Cristiano Biraghi,,,31.0,1992.0,12.9,16,10,9,3,4,11,18,61.1,7,15,4,11,8,24,44,0
ITA-Serie A,2425,Torino,Duván Zapata,,,33.0,1991.0,6.5,7,5,2,0,5,0,3,0.0,3,2,1,1,2,9,7,0
ITA-Serie A,2425,Torino,Elif Elmas,,,24.0,1999.0,11.3,10,7,3,5,2,4,10,40.0,6,8,2,6,6,16,5,2
ITA-Serie A,2425,Torino,Eybi Nije,,,19.0,2005.0,4.4,5,1,3,1,1,0,3,0.0,3,5,1,4,0,5,1,0
ITA-Serie A,2425,Torino,Guillermo Maripán,,,30.0,1994.0,26.0,40,23,25,14,1,21,33,63.6,12,27,13,14,41,81,138,1
ITA-Serie A,2425,Torino,Gvidas Gineitis,,,20.0,2004.0,15.9,25,15,8,10,7,13,25,52.0,12,16,6,10,18,43,32,0
ITA-Serie A,2425,Torino,Ivan Ilić,,,23.0,2001.0,10.2,5,2,0,4,1,2,8,25.0,6,0,0,0,5,10,10,0
ITA-Serie A,2425,Torino,Karol Linetty,,,29.0,1995.0,17.1,39,23,17,19,3,20,41,48.8,21,14,5,9,12,51,31,1
ITA-Serie A,2425,Torino,Marcus Pedersen,,,24.0,2000.0,15.1,13,8,6,6,1,10,16,62.5,6,11,2,9,13,26,34,1
ITA-Serie A,2425,Torino,Mërgim Vojvoda,,,29.0,1995.0,12.3,18,10,5,9,4,7,14,50.0,7,13,3,10,7,25,24,1
ITA-Serie A,2425,Torino,Nikola Vlašić,,,26.0,1997.0,23.5,37,19,11,17,9,12,30,40.0,18,15,3,12,9,46,15,0
ITA-Serie A,2425,Torino,Raoul Bellanova,,,24.0,2000.0,1.0,0,0,0,0,0,0,1,0.0,1,0,0,0,0,0,4,0
ITA-Serie A,2425,Torino,Saba Sazonov,,,22.0,2002.0,0.0,0,0,0,0,0,0,0,,0,1,1,0,0,0,0,0
ITA-Serie A,2425,Torino,Samuele Ricci,,,22.0,2001.0,31.4,35,21,15,14,6,18,28,64.3,10,23,9,14,25,60,51,2
ITA-Serie A,2425,Torino,Saúl Coco,,,25.0,1999.0,31.6,46,26,31,14,1,19,30,63.3,11,49,31,18,38,84,157,4
ITA-Serie A,2425,Torino,Sebastian Walukiewicz,,,24.0,2000.0,18.5,38,20,18,16,4,23,31,74.2,8,21,8,13,18,56,60,0
ITA-Serie A,2425,Torino,Sergiu Perciun,,,18.0,2006.0,1.7,2,2,0,0,2,1,4,25.0,3,2,0,2,1,3,2,0
ITA-Serie A,2425,Torino,Tommaso Gabellini,,,17.0,2006.0,0.1,0,0,0,0,0,0,0,,0,0,0,0,0,0,0,0
ITA-Serie A,2425,Torino,Valentino Lazaro,,,28.0,1996.0,25.6,26,12,10,12,4,15,30,50.0,15,28,5,23,11,37,38,1
ITA-Serie A,2425,Torino,Vanja Milinković-Savić,,,27.0,1997.0,37.0,1,0,1,0,0,1,3,33.3,2,0,0,0,0,1,18,4
ITA-Serie A,2425,Torino,Yann Karamoh,,,26.0,1998.0,11.6,5,2,2,1,2,4,9,44.4,5,10,2,8,3,8,5,0
ITA-Serie A,2425,Udinese,Alexis Sánchez,,,35.0,1988.0,4.9,3,1,0,2,1,1,7,14.3,6,5,0,5,4,7,1,1
ITA-Serie A,2425,Udinese,Arthur Atta,,,21.0,2003.0,13.9,20,12,9,10,1,10,15,66.7,5,9,5,4,7,27,15,1
ITA-Serie A,2425,Udinese,Brenner,,,24.0,2000.0,4.3,6,4,2,3,1,3,8,37.5,5,4,0,4,1,7,6,0
ITA-Serie A,2425,Udinese,Christian Kabasele,,,33.0,1991.0,12.9,17,9,10,7,0,11,14,78.6,3,14,8,6,14,31,75,1
ITA-Serie A,2425,Udinese,Damián Pizarro,,,19.0,2005.0,0.2,0,0,0,0,0,0,0,,0,0,0,0,0,0,0,0
ITA-Serie A,2425,Udinese,Daniele Padelli,,,38.0,1985.0,1.0,0,0,0,0,0,0,1,0.0,1,0,0,0,0,0,0,0
ITA-Serie A,2425,Udinese,Enzo Ebosse,,,25.0,1999.0,1.0,0,0,0,0,0,0,2,0.0,2,3,3,0,1,1,1,0
ITA-Serie A,2425,Udinese,Florian Thauvin,,,31.0,1993.0,21.7,20,14,9,8,3,10,25,40.0,15,6,0,6,7,27,10,0
ITA-Serie A,2425,Udinese,Hassane Kamara,,,30.0,1994.0,22.2,35,25,20,11,4,16,28,57.1,12,23,5,18,26,61,49,1
ITA-Serie A,2425,Udinese,Iker Bravo,,,19.0,2005.0,7.6,10,6,3,5,2,5,9,55.6,4,4,1,3,1,11,4,0
ITA-Serie A,2425,Udinese,Jaka Bijol,,,25.0,1999.0,32.9,43,25,32,10,1,21,40,52.5,19,38,18,20,38,81,182,1
ITA-Serie A,2425,Udinese,James Abankwah,,,20.0,2004.0,1.0,4,2,4,0,0,2,3,66.7,1,2,1,1,1,5,3,0
ITA-Serie A,2425,Udinese,Jesper Karlström,,,29.0,1995.0,35.4,61,34,32,21,8,25,51,49.0,26,28,11,17,35,96,82,5
ITA-Serie A,2425,Udinese,Jordan Zemura,,,24.0,1999.0,15.7,31,14,14,12,5,17,29,58.6,12,17,4,13,16,47,41,0
ITA-Serie A,2425,Udinese,Jurgen Ekkelenkamp,,,24.0,2000.0,21.0,36,25,10,22,4,18,35,51.4,17,26,4,22,12,48,26,0
ITA-Serie A,2425,Udinese,Keinan Davis,,,26.0,1998.0,11.8,9,4,1,4,4,3,6,50.0,3,2,1,1,1,10,5,0
ITA-Serie A,2425,Udinese,Kingsley Ehizibue,,,29.0,1995.0,27.8,55,35,31,18,6,25,41,61.0,16,41,14,27,23,78,70,5
ITA-Serie A,2425,Udinese,Lautaro Gianetti,,,30.0,1993.0,9.8,22,10,16,5,1,14,20,70.0,6,20,10,10,15,37,49,1
ITA-Serie A,2425,Udinese,Lorenzo Lucca,,,23.0,2000.0,26.1,10,6,3,2,5,5,11,45.5,6,18,1,17,7,17,27,0
ITA-Serie A,2425,Udinese,Maduka Okoye,,,24.0,1999.0,25.0,0,0,0,0,0,0,0,,0,0,0,0,0,0,12,1
ITA-Serie A,2425,Udinese,Martín Payero,,,25.0,1998.0,15.3,24,16,4,14,6,8,16,50.0,8,16,2,14,13,37,13,0
ITA-Serie A,2425,Udinese,Matteo Palma,,,16.0,2008.0,0.1,0,0,0,0,0,0,0,,0,1,1,0,0,0,1,0
ITA-Serie A,2425,Udinese,Nehuén Pérez,,,24.0,2000.0,2.0,1,1,0,0,1,0,1,0.0,1,2,2,0,1,2,7,0
ITA-Serie A,2425,Udinese,Oier Zarraga,,,25.0,1999.0,10.0,19,13,7,10,2,10,22,45.5,12,9,5,4,2,21,8,0
ITA-Serie A,2425,Udinese,Oumar Solet,,,24.0,2000.0,18.6,33,19,18,13,2,21,30,70.0,9,32,19,13,17,50,78,4
ITA-Serie A,2425,Udinese,Razvan Sava,,,22.0,2002.0,12.0,0,0,0,0,0,0,0,,0,0,0,0,0,0,6,2
ITA-Serie A,2425,Udinese,Rui Modesto,,,24.0,1999.0,6.8,16,12,4,9,3,7,9,77.8,2,10,0,10,8,24,13,0
ITA-Serie A,2425,Udinese,Sandi Lovrić,,,26.0,1998.0,25.6,46,29,25,17,4,22,44,50.0,22,33,5,28,22,68,27,1
ITA-Serie A,2425,Udinese,Simone Pafundi,,,18.0,2006.0,1.3,3,3,2,0,1,1,4,25.0,3,0,0,0,0,3,1,0
ITA-Serie A,2425,Udinese,Souleymane Touré,,,21.0,2003.0,8.1,7,6,4,3,0,4,5,80.0,1,15,6,9,9,16,17,1
ITA-Serie A,2425,Udinese,Thomas Kristensen,,,22.0,2002.0,19.5,31,21,16,11,4,20,32,62.5,12,18,13,5,21,52,80,2
ITA-Serie A,2425,Venezia,Alessandro Marcandalli,,,21.0,2002.0,3.9,8,6,6,2,0,3,6,50.0,3,6,3,3,2,10,26,0
ITA-Serie A,2425,Venezia,Alessio Zerbin,,,25.0,1999.0,16.9,51,28,30,12,9,29,52,55.8,23,28,3,25,15,66,25,1
ITA-Serie A,2425,Venezia,Alfred Duncan,,,31.0,1993.0,10.6,17,8,4,11,2,5,14,35.7,9,7,2,5,8,25,8,0
ITA-Serie A,2425,Venezia,Antonio Candela,,,24.0,2000.0,11.2,31,21,13,11,7,18,26,69.2,8,7,5,2,8,39,22,2
ITA-Serie A,2425,Venezia,Antonio Raimondo,,,20.0,2004.0,1.0,2,1,1,1,0,0,0,,0,0,0,0,0,2,0,1
ITA-Serie A,2425,Venezia,Bjarki Bjarkason,,,24.0,2000.0,1.8,3,2,2,1,0,1,2,50.0,1,1,0,1,2,5,4,0
ITA-Serie A,2425,Venezia,Cheick Oumar Conde,,,24.0,2000.0,1.7,6,5,3,2,1,2,5,40.0,3,7,2,5,4,10,3,0
ITA-Serie A,2425,Venezia,Christian Gytkjær,,,34.0,1990.0,8.4,6,4,2,2,2,1,2,50.0,1,3,1,2,0,6,8,0
ITA-Serie A,2425,Venezia,Daniel Fila,,,21.0,2002.0,5.5,2,0,0,1,1,0,2,0.0,2,6,0,6,0,2,5,0
ITA-Serie A,2425,Venezia,Domen Črnigoj,,,28.0,1995.0,1.5,4,2,0,1,3,1,2,50.0,1,5,2,3,4,8,4,0
ITA-Serie A,2425,Venezia,Fali Candé,,,26.0,1998.0,17.0,25,19,14,10,1,16,23,69.6,7,21,15,6,15,40,90,2
ITA-Serie A,2425,Venezia,Filip Stankovic,,,22.0,2002.0,15.2,0,0,0,0,0,0,0,,0,0,0,0,0,0,11,2
ITA-Serie A,2425,Venezia,Francesco Zampano,,,30.0,1993.0,18.2,31,20,19,10,2,14,31,45.2,17,21,1,20,6,37,29,2
ITA-Serie A,2425,Venezia,Franco Carboni,,,21.0,2003.0,2.5,5,3,5,0,0,5,8,62.5,3,1,1,0,0,5,11,0
ITA-Serie A,2425,Venezia,Gaetano Oristanio,,,21.0,2002.0,25.7,17,13,5,8,4,7,15,46.7,8,16,0,16,6,23,6,1
ITA-Serie A,2425,Venezia,Gianluca Busio,,,22.0,2002.0,28.0,46,31,24,12,10,20,47,42.6,27,36,8,28,19,65,52,0
ITA-Serie A,2425,Venezia,Giorgio Altare,,,25.0,1998.0,8.4,13,12,8,3,2,8,15,53.3,7,21,11,10,17,30,49,0
ITA-Serie A,2425,Venezia,Hans Nicolussi Caviglia,,,24.0,2000.0,31.8,47,28,17,22,8,29,64,45.3,35,39,12,27,28,75,55,2
ITA-Serie A,2425,Venezia,Ionuț Radu,,,27.0,1997.0,15.0,0,0,0,0,0,0,0,,0,0,0,0,0,0,9,0
ITA-Serie A,2425,Venezia,Issa Doumbia,,,20.0,2003.0,10.4,14,8,6,7,1,7,17,41.2,10,17,5,12,9,23,14,1
ITA-Serie A,2425,Venezia,Jay Idzes,,,24.0,2000.0,34.7,45,29,24,17,4,17,33,51.5,16,52,32,20,32,77,156,0
ITA-Serie A,2425,Venezia,Jesse Joronen,,,31.0,1993.0,7.8,0,0,0,0,0,0,0,,0,0,0,0,0,0,4,1
ITA-Serie A,2425,Venezia,Joel Pohjanpalo,,,29.0,1994.0,17.8,3,3,1,2,0,0,4,0.0,4,7,4,3,4,7,24,0
ITA-Serie A,2425,Venezia,John Yeboah,,,24.0,2000.0,13.6,6,3,1,3,2,1,10,10.0,9,4,0,4,4,10,2,0
ITA-Serie A,2425,Venezia,Joël Schingtienne,,,21.0,2002.0,12.5,27,16,18,7,2,12,19,63.2,7,18,9,9,14,41,25,5
ITA-Serie A,2425,Venezia,Kike Pérez,,,27.0,1997.0,12.4,41,25,18,12,11,18,44,40.9,26,14,2,12,10,51,15,0
ITA-Serie A,2425,Venezia,Magnus Kofod Andersen,,,25.0,1999.0,7.7,13,4,3,9,1,4,10,40.0,6,7,2,5,6,19,12,0
ITA-Serie A,2425,Venezia,Marin Šverko,,,26.0,1998.0,12.4,20,9,14,6,0,10,12,83.3,2,10,5,5,16,36,45,3
ITA-Serie A,2425,Venezia,Michael Svoboda,,,25.0,1998.0,14.6,26,14,19,6,1,8,19,42.1,11,19,11,8,22,48,66,2
ITA-Serie A,2425,Venezia,Mikael Ellertsson,,,22.0,2002.0,27.4,58,26,37,14,7,33,61,54.1,28,42,5,37,17,75,79,0
ITA-Serie A,2425,Venezia,Mirko Marić,,,29.0,1995.0,4.0,6,3,5,1,0,2,5,40.0,3,3,1,2,1,7,10,0
ITA-Serie A,2425,Venezia,Nicholas Pierini,,,25.0,1998.0,0.9,0,0,0,0,0,0,1,0.0,1,2,0,2,0,0,0,0
ITA-Serie A,2425,Venezia,Nunzio Lella,,,24.0,2000.0,0.1,0,0,0,0,0,0,0,,0,0,0,0,0,0,0,0
ITA-Serie A,2425,Venezia,Richie Sagrado,,,20.0,2004.0,1.6,2,2,1,1,0,1,1,100.0,0,1,0,1,3,5,4,0
ITA-Serie A,2425,Venezia,Ridgeciano Haps,,,31.0,1993.0,15.2,30,16,19,8,3,14,22,63.6,8,18,3,15,7,37,48,0
ITA-Serie A,2425,Venezia,Saad El Haddad,,,19.0,2005.0,0.3,0,0,0,0,0,0,0,,0,0,0,0,0,0,0,0
